AAACCTGAGCAAATCA	DS7
AAACCTGCACTCTGTC	DS7
AAACCTGCATATGGTC	DS7
AAACCTGGTCTACCTC	VU
AAACCTGGTTAAGACA	DS6
AAACCTGTCACCCGAG	DS7
AAACCTGTCTGTCCGT	DS7
AAACGGGAGACTACAA	DS7
AAACGGGAGGGCTCTC	DS3
AAACGGGAGTGTCTCA	DS8
AAACGGGCAAAGTGCG	DS8
AAACGGGCAATCGGTT	DS6
AAACGGGCACAGTCGC	DS9
AAACGGGCAGGCGATA	DS7
AAACGGGGTAGCCTCG	DS6
AAACGGGGTCCATGAT	DS9
AAACGGGGTTAAGTAG	DS3
AAACGGGGTTGAGGTG	DS6
AAACGGGTCCGGGTGT	DS7
AAACGGGTCTCGTTTA	DS8
AAAGATGAGCTAAACA	VU
AAAGATGAGTATTGGA	VU
AAAGATGAGTGTCCAT	DS7
AAAGATGCAATGGTCT	DS8
AAAGATGCAATGTTGC	DS7
AAAGATGCATAAGACA	VU
AAAGATGGTCTAACGT	DS7
AAAGATGGTCTGGTCG	DS9
AAAGATGGTTAAGGGC	DS6
AAAGATGTCACCGTAA	DS6
AAAGATGTCAGGTAAA	DS8
AAAGATGTCATCGATG	DS6
AAAGATGTCCCACTTG	DS6
AAAGATGTCGCGATCG	DS8
AAAGCAAAGAGTGACC	DS8
AAAGCAAAGTGGTCCC	DS3
AAAGCAACAAACTGCT	DS9
AAAGCAACAATCACAC	DS7
AAAGCAACAGACAAAT	DS6
AAAGCAAGTAGCCTCG	DS7
AAAGCAATCTACTTAC	DS6
AAAGTAGAGGTAGCTG	DS7
AAAGTAGAGGTGGGTT	VU
AAAGTAGAGTGACATA	DS6
AAAGTAGCATACCATG	DS8
AAAGTAGCATCCGGGT	DS3
AAAGTAGCATGGTCAT	DS8
AAAGTAGCATGTAGTC	DS3
AAAGTAGGTAATAGCA	DS6
AAAGTAGGTACTCTCC	DS8
AAAGTAGGTCAAAGCG	VU
AAAGTAGGTCAGAAGC	DS8
AAAGTAGGTCATCCCT	DS9
AAAGTAGGTGCAGTAG	DS9
AAAGTAGTCAACTCTT	DS6
AAAGTAGTCCACGTTC	DS9
AAATGCCAGATAGCAT	DS8
AAATGCCAGTTGTAGA	DS8
AAATGCCCACTTAACG	DS6
AAATGCCCATATGGTC	DS7
AAATGCCGTCACACGC	DS3
AAATGCCTCCAAACTG	DS6
AAATGCCTCCTAAGTG	DS7
AAATGCCTCTAACCGA	DS6
AAATGCCTCTAAGCCA	DS8
AACACGTAGCCGGTAA	VU
AACACGTCAAAGTGCG	DS3
AACACGTCAAGCTGGA	DS7
AACACGTCACCGCTAG	DS6
AACACGTCAGTCTTCC	DS6
AACACGTGTTGCCTCT	DS9
AACACGTTCACAGGCC	DS6
AACACGTTCGTACCGG	DS6
AACACGTTCTATCGCC	DS7
AACACGTTCTGTTTGT	DS6
AACCATGAGACTGTAA	DS6
AACCATGAGAGAACAG	DS8
AACCATGAGCTAGTTC	DS6
AACCATGAGGACATTA	DS8
AACCATGCACAGACTT	DS6
AACCATGCACCACCAG	VU
AACCATGCAGGCTCAC	VU
AACCATGCAGTAACGG	DS6
AACCATGGTACATCCA	DS6
AACCATGGTCTAAAGA	DS3
AACCATGGTCTCTCTG	DS8
AACCATGGTTAAGGGC	DS6
AACCATGTCCCATTTA	VU
AACCATGTCGCAGGCT	DS9
AACCATGTCTAACTTC	VU
AACCATGTCTCGTTTA	DS3
AACCGCGAGAGTGACC	DS8
AACCGCGAGCTTATCG	DS8
AACCGCGAGGCGCTCT	DS8
AACCGCGAGGGCTCTC	DS8
AACCGCGCAGGACCCT	VU
AACCGCGCATCAGTCA	DS3
AACCGCGCATGGATGG	DS3
AACCGCGGTAAATGAC	DS6
AACCGCGGTATCAGTC	DS7
AACCGCGGTCTTGCGG	DS6
AACCGCGTCAACGGCC	DS8
AACCGCGTCCAGAGGA	DS3
AACCGCGTCCGTTGCT	VU
AACCGCGTCTTTACGT	VU
AACGTTGAGAGCCTAG	DS6
AACGTTGAGATGAGAG	DS3
AACGTTGAGCGTAATA	DS3
AACGTTGAGCTAAACA	DS6
AACGTTGAGCTTATCG	DS6
AACGTTGAGTATGACA	DS8
AACGTTGCACAACTGT	DS7
AACGTTGCACCACCAG	DS6
AACGTTGCATTCGACA	DS8
AACGTTGTCGGACAAG	DS9
AACGTTGTCGGATGTT	VU
AACGTTGTCGGGAGTA	DS9
AACGTTGTCTGGTATG	DS3
AACGTTGTCTTGCAAG	DS9
AACTCAGAGACTGTAA	DS7
AACTCAGAGCTCCCAG	DS6
AACTCAGCAACTTGAC	VU
AACTCAGCAGCTGCTG	DS3
AACTCAGCATCGGACC	VU
AACTCAGCATCGTCGG	VU
AACTCAGCATTCTCAT	VU
AACTCAGTCGCGGATC	VU
AACTCCCAGATAGTCA	DS3
AACTCCCAGTGACATA	DS7
AACTCCCAGTTTAGGA	DS6
AACTCCCCAATGAATG	VU
AACTCCCCACAAGCCC	DS8
AACTCCCCACTGTTAG	DS3
AACTCCCCAGGTGGAT	DS7
AACTCCCCATACAGCT	VU
AACTCCCTCAACACAC	DS3
AACTCCCTCATGCATG	DS9
AACTCCCTCCATGCTC	DS6
AACTCCCTCCGCGCAA	DS3
AACTCCCTCGCGGATC	DS8
AACTCCCTCGCTGATA	DS7
AACTCTTAGCTTCGCG	DS6
AACTCTTAGTCTCAAC	DS6
AACTCTTCAGCTATTG	DS3
AACTCTTCAGGCTGAA	DS6
AACTCTTCATCGGACC	DS6
AACTCTTCATGCAACT	DS8
AACTCTTTCGCGATCG	DS9
AACTCTTTCTGTGCAA	DS9
AACTGGTAGATGAGAG	DS7
AACTGGTCAAAGGTGC	DS9
AACTGGTCACATCTTT	VU
AACTGGTCACCTCGTT	DS9
AACTGGTCAGTCTTCC	DS6
AACTGGTGTAAGAGAG	DS8
AACTGGTGTACTTCTT	DS8
AACTGGTGTAGCGCTC	DS9
AACTGGTGTGGTCTCG	DS9
AACTGGTGTTACGACT	VU
AACTGGTTCAGCGACC	DS8
AACTGGTTCCTAAGTG	DS6
AACTGGTTCTCAACTT	DS8
AACTTTCAGCGATTCT	DS6
AACTTTCAGGACAGAA	DS6
AACTTTCAGGCAGTCA	DS8
AACTTTCCAGCTGTAT	DS8
AACTTTCCAGTTAACC	DS6
AACTTTCCATACCATG	DS9
AACTTTCCATCTCGCT	DS6
AACTTTCGTACCGTAT	DS6
AACTTTCGTAGCGTCC	DS3
AACTTTCGTCCCGACA	DS6
AACTTTCGTCGCTTCT	DS8
AACTTTCGTTAAGACA	DS6
AACTTTCTCACGGTTA	DS8
AACTTTCTCCGCGTTT	DS8
AACTTTCTCGACCAGC	VU
AAGACCTAGCTGGAAC	VU
AAGACCTAGGCTAGCA	DS8
AAGACCTAGGGATCTG	DS9
AAGACCTCAGTCTTCC	VU
AAGACCTCAGTGACAG	DS6
AAGACCTGTAAGTGTA	DS3
AAGACCTGTCCGAATT	DS8
AAGACCTGTCCTGCTT	VU
AAGACCTTCCTAGTGA	DS3
AAGACCTTCGACAGCC	DS6
AAGACCTTCGTACGGC	DS9
AAGACCTTCGTCCGTT	DS3
AAGACCTTCTGTCTAT	DS6
AAGCCGCAGGATTCGG	DS6
AAGCCGCAGTAGCCGA	DS6
AAGCCGCAGTTGAGTA	VU
AAGCCGCCAGCTGTAT	DS8
AAGCCGCCAGGCAGTA	DS9
AAGCCGCCAGTATGCT	DS3
AAGCCGCCATTCACTT	VU
AAGCCGCGTTGGACCC	VU
AAGCCGCTCATTGCCC	DS6
AAGCCGCTCCTTGCCA	DS3
AAGGAGCAGACTTGAA	DS6
AAGGAGCCAGAAGCAC	DS9
AAGGAGCCAGATAATG	DS9
AAGGAGCCATCGGACC	DS8
AAGGAGCGTACATGTC	DS9
AAGGAGCGTCTAGCCG	VU
AAGGAGCGTGTGCGTC	DS8
AAGGAGCTCATGTCTT	DS8
AAGGAGCTCCCTCAGT	DS6
AAGGAGCTCGTAGATC	VU
AAGGCAGCACCTCGGA	DS3
AAGGCAGGTATGAAAC	DS6
AAGGCAGGTCAACTGT	DS3
AAGGCAGGTCGCGTGT	DS6
AAGGCAGGTGCCTGCA	DS9
AAGGCAGTCATTCACT	DS9
AAGGCAGTCCCTGACT	DS7
AAGGCAGTCGATAGAA	DS7
AAGGCAGTCTGAGTGT	DS6
AAGGTTCAGAGTTGGC	DS9
AAGGTTCAGATGCCTT	DS7
AAGGTTCAGGCATGGT	DS9
AAGGTTCAGGGCACTA	DS3
AAGGTTCAGTACGACG	DS3
AAGGTTCAGTCCCACG	DS3
AAGGTTCGTAAGAGGA	DS6
AAGGTTCGTAGAGTGC	DS7
AAGGTTCGTCTGCGGT	DS6
AAGGTTCGTGCTCTTC	DS6
AAGGTTCTCGATGAGG	DS3
AAGGTTCTCGCGTTTC	VU
AAGTCTGAGATCCGAG	DS3
AAGTCTGAGCAGCGTA	DS3
AAGTCTGAGCTAGTTC	DS8
AAGTCTGAGTGTTTGC	DS6
AAGTCTGCAGCAGTTT	DS7
AAGTCTGCAGCCTATA	DS6
AAGTCTGGTGGTCTCG	DS7
AAGTCTGTCACCCGAG	DS6
AAGTCTGTCCAAAGTC	DS8
AAGTCTGTCTAGAGTC	DS6
AATCCAGAGAGCAATT	DS3
AATCCAGAGCGTAATA	DS6
AATCCAGCACAACGTT	VU
AATCCAGGTAGCAAAT	VU
AATCCAGGTCAACTGT	DS7
AATCCAGGTCGAAAGC	DS7
AATCCAGTCACCTTAT	DS3
AATCCAGTCTCTGCTG	DS7
AATCCAGTCTTTACAC	DS6
AATCGGTAGCCTTGAT	DS7
AATCGGTAGGACGAAA	VU
AATCGGTCAAAGTCAA	DS9
AATCGGTCAAGCTGTT	DS6
AATCGGTCATGGTTGT	DS9
AATCGGTGTAAATACG	DS3
AATCGGTGTAATCACC	DS9
AATCGGTGTAGATTAG	DS6
AATCGGTGTCCGAGTC	DS6
AATCGGTGTCGCCATG	DS7
AATCGGTGTGAAATCA	DS8
AATCGGTGTTCCATGA	DS9
AATCGGTTCACTTATC	DS7
AATCGGTTCATGCATG	DS8
AATCGGTTCGGCCGAT	DS7
AATCGGTTCGTTGCCT	DS6
ACACCAAAGTTAACGA	DS3
ACACCAACACCACGTG	DS9
ACACCAACACCAGGTC	DS8
ACACCAACATATGAGA	DS8
ACACCAACATTAACCG	DS8
ACACCAAGTAGGCTGA	VU
ACACCAAGTTACGCGC	DS7
ACACCAATCACGAAGG	VU
ACACCCTAGCTACCGC	DS6
ACACCCTAGGGAAACA	DS6
ACACCCTAGGTACTCT	DS7
ACACCCTAGGTAGCTG	DS3
ACACCCTCAAATCCGT	VU
ACACCCTCAATGGATA	DS7
ACACCCTCACGTCAGC	VU
ACACCCTCAGTACACT	DS9
ACACCCTGTCCCTTGT	DS9
ACACCCTGTGTGAATA	DS8
ACACCCTGTGTGACCC	DS3
ACACCCTTCACGCGGT	DS7
ACACCCTTCACTATTC	DS7
ACACCCTTCGAACTGT	DS6
ACACCCTTCTCACATT	DS6
ACACCGGAGTACGATA	DS6
ACACCGGCAATGAAAC	DS6
ACACCGGCAATTGCTG	DS9
ACACCGGCACTCAGGC	DS6
ACACCGGGTAGCGTGA	DS7
ACACCGGGTGATGATA	DS8
ACACCGGGTTCAACCA	DS3
ACACCGGTCCGAATGT	DS6
ACACCGGTCTGCTGCT	DS7
ACACCGGTCTTGTCAT	DS6
ACACTGAAGAATTGTG	DS6
ACACTGAAGCCAGTAG	DS7
ACACTGAAGCGCTCCA	DS9
ACACTGACAGCATGAG	DS8
ACACTGACAGGGTACA	VU
ACACTGACAGTAGAGC	DS6
ACACTGAGTACCTACA	DS6
ACACTGAGTCTACCTC	DS6
ACACTGATCATCGATG	DS6
ACACTGATCATGTCTT	DS6
ACACTGATCGGTTCGG	DS8
ACACTGATCTCTAAGG	DS7
ACAGCCGAGATGCGAC	DS6
ACAGCCGAGCCCAGCT	DS6
ACAGCCGAGGAACTGC	VU
ACAGCCGAGGTGCACA	DS9
ACAGCCGCAAGAAAGG	DS8
ACAGCCGCAAGTAGTA	VU
ACAGCCGCATGTTCCC	DS9
ACAGCCGGTGCCTGGT	DS8
ACAGCCGTCACCACCT	DS9
ACAGCCGTCCAGTATG	DS6
ACAGCCGTCTGCGTAA	DS6
ACAGCTAAGCCAGTTT	DS6
ACAGCTAAGGTACTCT	DS9
ACAGCTACAACTGCGC	DS6
ACAGCTACAGGAATGC	DS3
ACAGCTACATACCATG	DS8
ACAGCTACATGGATGG	DS3
ACAGCTATCAGGATCT	DS6
ACAGCTATCCTGTACC	DS8
ACAGCTATCTATCCCG	DS7
ACATACGAGAGGTTAT	DS6
ACATACGAGGATGGAA	DS6
ACATACGAGGCTAGAC	DS7
ACATACGAGGGCACTA	DS7
ACATACGCAAACGTGG	DS3
ACATACGCAATGACCT	DS3
ACATACGCACGAAATA	DS6
ACATACGGTAGGGTAC	DS6
ACATACGGTTGGTGGA	DS7
ACATACGTCCCTCAGT	DS6
ACATACGTCGGACAAG	DS6
ACATACGTCGTCCGTT	DS6
ACATCAGAGGAATTAC	DS3
ACATCAGAGGGCATGT	DS7
ACATCAGCACAAGTAA	DS6
ACATCAGGTAGGACAC	DS7
ACATCAGTCAGGCAAG	DS7
ACATCAGTCTTAGCCC	DS3
ACATGGTAGACTTTCG	DS9
ACATGGTAGTGGGCTA	DS9
ACATGGTAGTGTGGCA	DS8
ACATGGTCAATACGCT	DS6
ACATGGTCACAACTGT	VU
ACATGGTGTAGCGCTC	DS7
ACATGGTTCAGTTCGA	DS9
ACATGGTTCCATGAAC	DS6
ACATGGTTCTGGCGAC	DS6
ACATGGTTCTTAGAGC	DS9
ACATGGTTCTTCGGTC	DS7
ACCAGTAAGCTTATCG	DS7
ACCAGTAAGGCATGGT	DS6
ACCAGTACAAGTACCT	DS9
ACCAGTACAGACTCGC	DS6
ACCAGTATCATCACCC	DS6
ACCAGTATCATGCTCC	DS3
ACCAGTATCGTCTGAA	DS7
ACCCACTAGATGTTAG	DS7
ACCCACTAGCTGTCTA	DS6
ACCCACTAGGATGTAT	DS9
ACCCACTAGTCATGCT	DS9
ACCCACTCACACCGCA	DS6
ACCCACTCACGGACAA	DS9
ACCCACTCAGCCAATT	DS7
ACCCACTCAGGTTTCA	DS8
ACCCACTGTACTTAGC	VU
ACCCACTGTCAGTGGA	DS9
ACCCACTGTCATACTG	DS8
ACCCACTGTGACGGTA	DS6
ACCCACTGTGCTGTAT	DS6
ACCCACTGTTAAGAAC	DS3
ACCCACTGTTACGGAG	DS6
ACCCACTTCAGCCTAA	DS6
ACCCACTTCGATAGAA	DS6
ACCGTAAAGAGTCGGT	DS6
ACCGTAAAGTCCGTAT	DS6
ACCGTAACAATGGAAT	DS3
ACCGTAACAGATCTGT	VU
ACCGTAACATCGATGT	DS3
ACCGTAAGTAAGCACG	DS7
ACCGTAAGTCAACTGT	VU
ACCGTAATCACCGTAA	VU
ACCGTAATCACTTACT	DS8
ACCGTAATCGGAATCT	DS6
ACCGTAATCTAGCACA	DS6
ACCTTTAAGGAGTAGA	DS8
ACCTTTAAGTGGGATC	DS9
ACCTTTACAAGGCTCC	DS8
ACCTTTACACCCTATC	DS3
ACCTTTACACGAAATA	VU
ACCTTTACACGTTGGC	DS6
ACCTTTACAGGTGGAT	DS6
ACCTTTACATACGCTA	DS6
ACCTTTACATATACCG	DS8
ACCTTTAGTTCAACCA	VU
ACCTTTATCAGTCAGT	DS6
ACCTTTATCTCTGCTG	DS7
ACCTTTATCTGTCTCG	DS8
ACGAGCCAGATTACCC	DS7
ACGAGCCAGCTACCGC	DS9
ACGAGCCAGGCATTGG	VU
ACGAGCCCAATGCCAT	DS6
ACGAGCCCACGGTAAG	DS8
ACGAGCCCACTGAAGG	DS8
ACGAGCCCATACCATG	DS8
ACGAGCCCATGCCTAA	DS6
ACGAGCCCATTGAGCT	DS7
ACGAGCCGTAAGTGTA	DS8
ACGAGCCGTAGTACCT	DS7
ACGAGCCGTCTAGCCG	DS9
ACGAGCCGTCTAGCGC	DS9
ACGAGCCGTGCGAAAC	DS7
ACGAGCCGTTAGTGGG	DS6
ACGAGCCGTTCAACCA	DS7
ACGAGCCTCAAGATCC	DS7
ACGAGCCTCCGCAGTG	DS8
ACGAGCCTCCTATGTT	DS7
ACGAGCCTCCTTTCTC	VU
ACGAGCCTCTCTAAGG	DS3
ACGAGGAAGAAGCCCA	DS6
ACGAGGAAGAGATGAG	DS3
ACGAGGAAGTCAAGCG	DS6
ACGAGGACACGGCTAC	DS6
ACGAGGACAGCCTTGG	DS6
ACGAGGAGTCTCTTAT	DS6
ACGAGGATCACTATTC	DS6
ACGAGGATCATAACCG	DS7
ACGATACAGACTGGGT	DS8
ACGATACAGCTCCCAG	DS8
ACGATACAGTAGCCGA	DS6
ACGATACCAACTTGAC	DS6
ACGATACCAGCGTTCG	DS9
ACGATACCAGGCGATA	DS6
ACGATACCATAAAGGT	DS8
ACGATACTCGCTTAGA	DS6
ACGATGTAGAATGTGT	DS6
ACGATGTAGCAATATG	DS9
ACGATGTAGCACACAG	DS8
ACGATGTAGGCTCAGA	VU
ACGATGTAGTCATGCT	DS6
ACGATGTAGTGTTTGC	DS8
ACGATGTCAAGGACAC	DS6
ACGATGTCATATGAGA	DS6
ACGATGTGTGCAACTT	DS3
ACGATGTTCCGCTGTT	DS3
ACGATGTTCTGCCCTA	DS7
ACGATGTTCTGTCCGT	DS3
ACGCAGCAGGGTCTCC	DS9
ACGCAGCAGTCCAGGA	DS6
ACGCAGCCAAGCTGTT	DS8
ACGCAGCCAAGTCATC	DS6
ACGCAGCCAGCTCGCA	DS6
ACGCAGCGTAAATGAC	DS8
ACGCAGCGTCGAAAGC	DS9
ACGCAGCTCACCAGGC	VU
ACGCAGCTCATAGCAC	DS3
ACGCAGCTCATGGTCA	DS8
ACGCAGCTCCTCCTAG	DS9
ACGCAGCTCTCAACTT	DS6
ACGCCAGAGGGTTCCC	DS3
ACGCCAGAGTCTTGCA	DS8
ACGCCAGCAGACTCGC	DS9
ACGCCAGCATGGTTGT	DS8
ACGCCAGGTCCGACGT	DS3
ACGCCAGGTCTCTCTG	DS6
ACGCCAGGTTGAGTTC	DS7
ACGCCAGTCCGTTGTC	VU
ACGCCAGTCCTCAACC	DS6
ACGCCGAAGAATCTCC	DS3
ACGCCGAAGATCCGAG	DS8
ACGCCGAAGGGCTTCC	DS6
ACGCCGAAGGGTATCG	DS3
ACGCCGACAAGCCGCT	DS6
ACGCCGACACTAAGTC	DS3
ACGCCGACACTGAAGG	DS7
ACGCCGACATTATCTC	DS7
ACGCCGAGTACTTCTT	DS6
ACGCCGAGTCAAACTC	DS8
ACGCCGAGTCATGCCG	DS6
ACGCCGATCACGAAGG	DS6
ACGCCGATCATGCATG	DS7
ACGCCGATCTGATTCT	DS8
ACGGAGAAGATGCCTT	VU
ACGGAGAAGGCGCTCT	DS8
ACGGAGAAGTTAGCGG	DS6
ACGGAGACAAGCGTAG	VU
ACGGAGACAGGAACGT	DS3
ACGGAGAGTAGAGTGC	DS6
ACGGAGATCACCCGAG	DS3
ACGGAGATCATGCATG	DS8
ACGGAGATCTAGCACA	DS7
ACGGCCAAGGCTACGA	DS9
ACGGCCAAGTGTACTC	DS7
ACGGCCACAAGACGTG	DS7
ACGGCCACAAGCCTAT	DS7
ACGGCCACATTCTTAC	DS7
ACGGCCAGTAGCGTAG	DS8
ACGGCCAGTCTGCCAG	DS6
ACGGCCAGTGATGATA	DS7
ACGGCCATCAAACGGG	DS6
ACGGCCATCACAGTAC	DS6
ACGGCCATCCGTTGCT	DS7
ACGGCCATCTGCGACG	VU
ACGGGCTAGCTCCTTC	DS6
ACGGGCTAGGCTAGCA	DS8
ACGGGCTAGGTGATAT	DS8
ACGGGCTAGGTTCCTA	DS7
ACGGGCTCACCTCGGA	DS3
ACGGGCTCAGGAATGC	VU
ACGGGCTGTCAGGACA	DS3
ACGGGCTGTGCACGAA	DS3
ACGGGCTGTTGCGTTA	DS9
ACGGGCTTCCACTGGG	VU
ACGGGCTTCCTATTCA	DS9
ACGGGCTTCTGTACGA	DS3
ACGGGTCAGCTGGAAC	VU
ACGGGTCAGTAACCCT	DS6
ACGGGTCAGTCCCACG	DS9
ACGGGTCCATTCGACA	VU
ACGGGTCTCACATGCA	DS9
ACGGGTCTCAGTCCCT	VU
ACGGGTCTCGATGAGG	VU
ACGTCAAAGACCCACC	DS9
ACGTCAAAGCACCGCT	DS8
ACGTCAAAGTGTTAGA	DS9
ACGTCAACAATCAGAA	DS6
ACGTCAACAGTCAGAG	DS6
ACGTCAAGTAGCGTGA	DS3
ACGTCAAGTCTCTCGT	DS7
ACGTCAAGTGTGTGCC	DS6
ACGTCAAGTTCGTCTC	DS6
ACGTCAATCACCTCGT	DS6
ACGTCAATCTACTCAT	DS6
ACGTCAATCTGGCGAC	DS3
ACTATCTAGTTAACGA	DS6
ACTATCTCACACAGAG	DS6
ACTATCTCACTTCGAA	DS9
ACTATCTGTGCGATAG	DS6
ACTATCTGTTTGACAC	DS6
ACTATCTTCTGGTGTA	DS8
ACTATCTTCTTCAACT	DS7
ACTGAACAGCAGCGTA	DS6
ACTGAACAGTATTGGA	VU
ACTGAACAGTGGAGAA	VU
ACTGAACAGTTTGCGT	DS6
ACTGAACCAAACAACA	DS8
ACTGAACGTATAGGGC	DS8
ACTGAACGTATTAGCC	DS7
ACTGAACGTTAAGATG	DS3
ACTGAACTCAGCGACC	VU
ACTGAACTCGGCATCG	DS8
ACTGAGTAGAGACGAA	DS6
ACTGAGTAGCTAAGAT	DS6
ACTGAGTAGCTGCGAA	DS7
ACTGAGTAGGATATAC	DS7
ACTGAGTAGGCCCTCA	DS8
ACTGAGTCAAGTAGTA	DS3
ACTGAGTCATACTACG	DS6
ACTGAGTGTTAAGATG	DS9
ACTGAGTTCAGAGACG	DS6
ACTGAGTTCAGGTTCA	VU
ACTGAGTTCATCTGTT	DS3
ACTGAGTTCTGTCTAT	DS7
ACTGATGAGCTGGAAC	DS3
ACTGATGAGTGTACCT	DS7
ACTGATGCAATAACGA	VU
ACTGATGCACATTCGA	DS7
ACTGATGCACCTTGTC	DS3
ACTGATGGTCGGGTCT	VU
ACTGATGTCCAACCAA	DS9
ACTGATGTCTCTGTCG	DS3
ACTGATGTCTTGTACT	DS7
ACTGATGTCTTTCCTC	DS6
ACTGCTCAGATGTGGC	DS6
ACTGCTCAGCCAACAG	DS7
ACTGCTCAGCCCAGCT	DS6
ACTGCTCCATACAGCT	DS7
ACTGCTCGTACTCTCC	DS9
ACTGCTCGTATAGGTA	DS8
ACTGCTCGTGCACGAA	VU
ACTGCTCTCAAACCAC	DS6
ACTGCTCTCGGAAATA	DS3
ACTGCTCTCGTCTGAA	DS3
ACTGCTCTCGTGGGAA	DS8
ACTGTCCAGAGACGAA	DS7
ACTGTCCAGCGTCAAG	DS7
ACTGTCCAGCTGATAA	DS7
ACTGTCCCAATAAGCA	DS3
ACTGTCCCACCTATCC	DS6
ACTGTCCCAGGATCGA	DS6
ACTGTCCCAGGTCCAC	DS9
ACTGTCCCATGGGACA	DS6
ACTGTCCGTACGACCC	DS6
ACTGTCCGTAGAGTGC	DS6
ACTGTCCGTATAGTAG	DS7
ACTGTCCGTCCAACTA	VU
ACTGTCCGTCGATTGT	DS3
ACTGTCCGTCTACCTC	DS8
ACTGTCCGTCTGATTG	VU
ACTGTCCGTCTGCAAT	DS3
ACTGTCCGTTCAGACT	DS8
ACTGTCCTCGCGTAGC	DS6
ACTTACTAGGATGGAA	DS6
ACTTACTCACCTTGTC	VU
ACTTACTCACGGTAAG	DS8
ACTTACTCAGACGCCT	DS7
ACTTACTCAGCGATCC	DS6
ACTTACTGTAAATGTG	DS7
ACTTACTGTACAGACG	DS6
ACTTACTGTACAGTTC	DS9
ACTTACTGTCATCCCT	DS6
ACTTACTGTCATTAGC	DS3
ACTTACTGTCGCATAT	DS9
ACTTACTGTCTCCCTA	DS3
ACTTACTGTGCGATAG	DS9
ACTTACTGTGCTTCTC	DS8
ACTTACTGTTTAAGCC	DS6
ACTTACTGTTTGACTG	DS6
ACTTACTTCAAGCCTA	DS8
ACTTACTTCACGGTTA	DS6
ACTTACTTCAGCCTAA	DS3
ACTTACTTCCCATTAT	VU
ACTTACTTCCCATTTA	DS6
ACTTACTTCTCTTATG	DS8
ACTTACTTCTGATACG	DS8
ACTTGTTAGATAGGAG	VU
ACTTGTTAGCTAGGCA	DS9
ACTTGTTAGTGGAGAA	DS6
ACTTGTTCAAGACGTG	DS3
ACTTGTTCAGCTGTGC	DS8
ACTTGTTGTAAATGTG	DS7
ACTTGTTGTAATAGCA	DS7
ACTTGTTGTATATGGA	DS6
ACTTGTTGTGTTAAGA	VU
ACTTGTTTCGGACAAG	DS6
ACTTGTTTCGGTTCGG	DS8
ACTTGTTTCGTTACAG	DS7
ACTTTCAAGCGGCTTC	DS6
ACTTTCAAGTGTGGCA	DS8
ACTTTCACAGCGTTCG	DS9
ACTTTCACAGCTTAAC	DS6
ACTTTCACAGGTGGAT	DS8
ACTTTCAGTACTTAGC	DS6
ACTTTCAGTCACTTCC	DS6
ACTTTCAGTCGAAAGC	DS9
ACTTTCAGTCGCTTCT	DS9
ACTTTCAGTCTGATTG	DS8
ACTTTCAGTGGCTCCA	DS6
AGAATAGAGGCTCATT	DS6
AGAATAGAGTGTGAAT	DS3
AGAATAGCAGACAAAT	DS3
AGAATAGCATCTACGA	DS7
AGAATAGCATGCTGGC	DS8
AGAATAGCATGGTAGG	DS7
AGAATAGGTAATCGTC	DS6
AGAATAGGTAGTGAAT	DS3
AGAATAGGTGAAATCA	DS8
AGAATAGGTGGGTCAA	DS3
AGAATAGGTTGGTTTG	DS6
AGAATAGTCAGGTTCA	DS7
AGAATAGTCCGTACAA	DS9
AGACGTTAGATCACGG	DS6
AGACGTTAGCCAGTTT	DS8
AGACGTTAGTCCATAC	DS7
AGACGTTCACAAGACG	DS8
AGACGTTGTAGCGATG	DS9
AGACGTTGTCCGACGT	DS6
AGACGTTTCAACGGCC	DS6
AGACGTTTCACGAAGG	DS8
AGACGTTTCACTCTTA	VU
AGAGCGAAGAGTACAT	DS6
AGAGCGAAGCACGCCT	VU
AGAGCGAAGTGACTCT	DS6
AGAGCGACAAGCCGTC	DS8
AGAGCGACAAGGCTCC	DS8
AGAGCGACAGTAACGG	DS8
AGAGCGACATTACGAC	DS6
AGAGCGAGTCTGGTCG	DS6
AGAGCGAGTCTTTCAT	DS9
AGAGCGATCCGTTGCT	DS6
AGAGCGATCGAGGTAG	DS8
AGAGCTTCACAGACTT	VU
AGAGCTTCACGAAAGC	DS3
AGAGCTTCAGGTCCAC	DS6
AGAGCTTGTACAGTGG	DS9
AGAGCTTGTCGAGTTT	DS3
AGAGCTTGTTGAGTTC	DS3
AGAGCTTTCAGGCCCA	DS6
AGAGCTTTCCGTTGCT	VU
AGAGCTTTCGTTACAG	VU
AGAGTGGAGTAGGCCA	DS3
AGAGTGGCACGCCAGT	DS6
AGAGTGGCAGCATGAG	DS3
AGAGTGGCAGGTCCAC	DS6
AGAGTGGCAGTTCATG	DS7
AGAGTGGCATAAAGGT	DS7
AGAGTGGGTAGCTCCG	VU
AGAGTGGGTAGGCTGA	DS3
AGAGTGGGTCGCGTGT	DS3
AGAGTGGGTTCCCGAG	DS9
AGAGTGGTCCAAAGTC	DS3
AGAGTGGTCGGCCGAT	DS8
AGAGTGGTCTAGAGTC	DS9
AGATCTGAGATAGGAG	DS8
AGATCTGAGATCTGCT	DS6
AGATCTGAGCGCCTTG	DS6
AGATCTGAGGACTGGT	DS7
AGATCTGAGGGCTTGA	DS9
AGATCTGAGTGAACAT	DS3
AGATCTGCAATAGAGT	DS3
AGATCTGCAGACAAAT	DS7
AGATCTGGTCGTCTTC	DS8
AGATCTGGTGCAACGA	DS6
AGATCTGTCCATGAGT	DS7
AGATTGCAGCCGGTAA	DS6
AGATTGCAGTGGTCCC	DS9
AGATTGCCACGGTAGA	DS7
AGATTGCCAGTCAGCC	DS9
AGATTGCGTCACTGGC	DS3
AGATTGCGTCCATGAT	DS9
AGATTGCGTCGATTGT	DS7
AGATTGCGTCTAGGTT	DS3
AGATTGCGTTACCAGT	DS6
AGATTGCTCCCTCTTT	VU
AGATTGCTCGTCCGTT	DS7
AGCAGCCAGAACAATC	DS9
AGCAGCCAGAGTACAT	DS7
AGCAGCCAGCGTGAAC	DS6
AGCAGCCCAGGGTTAG	VU
AGCAGCCCATGCCTTC	DS8
AGCAGCCGTAGAAGGA	DS8
AGCAGCCGTAGTACCT	DS3
AGCAGCCGTCCGTGAC	DS6
AGCAGCCGTTTGTGTG	DS3
AGCAGCCTCTCACATT	DS9
AGCAGCCTCTGCGTAA	DS7
AGCATACAGAGGGCTT	DS3
AGCATACAGCGAAGGG	DS6
AGCATACAGCTCCTTC	DS3
AGCATACCAAGAAAGG	DS8
AGCATACCATCCTTGC	DS7
AGCATACCATGCATGT	DS7
AGCATACGTAAGGATT	DS8
AGCATACGTGCCTGCA	DS6
AGCATACGTTGCGTTA	DS3
AGCATACTCAACGGCC	DS3
AGCATACTCACGGTTA	DS6
AGCATACTCTCCGGTT	DS7
AGCATACTCTTGGGTA	DS9
AGCCTAAAGACTAAGT	DS6
AGCCTAACAAGCGTAG	VU
AGCCTAACACGGCTAC	DS6
AGCCTAACAGGGCATA	DS7
AGCCTAACAGTGGAGT	DS8
AGCCTAACATGCCACG	VU
AGCCTAAGTATAAACG	DS8
AGCCTAAGTCCAGTAT	DS7
AGCCTAAGTCTCTTAT	DS8
AGCCTAAGTGTTTGTG	DS7
AGCCTAAGTTGATTGC	DS3
AGCCTAATCGCCTGTT	VU
AGCCTAATCTGTGCAA	DS6
AGCGGTCAGGCAATTA	DS3
AGCGGTCCAAACGCGA	DS9
AGCGGTCCATGGGAAC	DS9
AGCGGTCCATTGCGGC	DS6
AGCGGTCGTCTAGAGG	DS7
AGCGGTCGTGCTGTAT	DS8
AGCGTATAGACAAAGG	DS7
AGCGTATAGACGCTTT	DS6
AGCGTATAGTACACCT	DS7
AGCGTATAGTGACATA	DS8
AGCGTATCAAGTCTAC	DS7
AGCGTATCAGTAGAGC	DS9
AGCGTATCAGTATGCT	DS6
AGCGTATCATACGCCG	DS6
AGCGTATGTAAAGTCA	DS3
AGCGTATGTCACCTAA	DS3
AGCGTATGTCCAAGTT	VU
AGCGTATTCCACGCAG	VU
AGCGTATTCCAGATCA	DS6
AGCGTATTCCCATTTA	DS8
AGCGTATTCTGGTTCC	DS7
AGCGTCGAGCCACCTG	DS7
AGCGTCGAGCCCAGCT	VU
AGCGTCGCAAACCTAC	DS6
AGCGTCGCAAGTCTGT	DS7
AGCGTCGCACATAACC	DS7
AGCGTCGCACGCTTTC	DS6
AGCGTCGGTCCGTGAC	DS6
AGCGTCGGTGTGTGCC	DS8
AGCGTCGGTTGTGGAG	DS3
AGCGTCGTCACTATTC	VU
AGCTCCTAGAGGTTAT	DS9
AGCTCCTAGGAATCGC	DS7
AGCTCCTAGGCAGTCA	DS7
AGCTCCTAGTAGCGGT	DS3
AGCTCCTAGTGGTAGC	DS7
AGCTCCTCAAGAGTCG	DS6
AGCTCCTCACAGGAGT	DS7
AGCTCCTCACATCCAA	VU
AGCTCCTCACCCATGG	DS6
AGCTCCTCACGGTAGA	DS6
AGCTCCTGTGTGTGCC	DS6
AGCTCCTTCAAGGCTT	DS3
AGCTCCTTCGATGAGG	DS7
AGCTCCTTCTCAAGTG	DS3
AGCTCTCAGAGACTTA	DS9
AGCTCTCAGCAGCCTC	DS8
AGCTCTCAGGTCATCT	DS7
AGCTCTCCATTTCAGG	DS7
AGCTCTCGTAATCACC	DS9
AGCTCTCGTATAGTAG	DS6
AGCTCTCGTCACCCAG	DS8
AGCTCTCGTCATATGC	DS6
AGCTCTCTCACATGCA	DS8
AGCTCTCTCAGAAATG	DS6
AGCTCTCTCTAACTTC	DS8
AGCTCTCTCTCGCATC	DS6
AGCTTGAAGCTCAACT	VU
AGCTTGAAGGATATAC	DS8
AGCTTGAAGTTTAGGA	DS6
AGCTTGACACTAAGTC	DS6
AGCTTGAGTCACACGC	DS7
AGCTTGATCAACACCA	DS8
AGCTTGATCCACTCCA	DS6
AGGCCACAGTTGTCGT	VU
AGGCCACCAATGGATA	DS7
AGGCCACCACCACGTG	DS6
AGGCCACCAGCGTCCA	DS6
AGGCCACCAGGCTGAA	DS9
AGGCCACCAGTTAACC	DS8
AGGCCACGTTCTGAAC	DS7
AGGCCACGTTTCGCTC	DS6
AGGCCACTCAACCAAC	VU
AGGCCACTCACTCCTG	DS6
AGGCCACTCTTGAGAC	DS6
AGGCCGTAGCAACGGT	DS7
AGGCCGTAGCAGACTG	DS6
AGGCCGTAGCCGTCGT	DS3
AGGCCGTAGCTAAACA	DS9
AGGCCGTCAACTGCTA	DS9
AGGCCGTCAAGAGTCG	DS8
AGGCCGTCATTGGTAC	DS6
AGGCCGTGTCATGCCG	DS3
AGGCCGTGTTGTCTTT	DS6
AGGCCGTTCCACTGGG	DS8
AGGCCGTTCGGCGCTA	DS6
AGGCCGTTCTTGCAAG	DS9
AGGGAGTAGAAACCAT	DS3
AGGGAGTAGCCGATTT	DS7
AGGGAGTAGCTGCAAG	DS9
AGGGAGTCAAGCCGTC	DS6
AGGGAGTCAGCTCGCA	DS3
AGGGAGTCAGCTGGCT	DS6
AGGGAGTCAGGAACGT	DS7
AGGGAGTCATGCCTTC	DS3
AGGGAGTGTATCACCA	DS6
AGGGAGTGTCCAAGTT	DS8
AGGGAGTGTGTTGAGG	DS7
AGGGAGTGTTTGACAC	DS6
AGGGAGTTCAACGAAA	DS9
AGGGAGTTCAGAAATG	DS3
AGGGAGTTCCTACAGA	DS8
AGGGATGAGGTAGCCA	DS6
AGGGATGAGTTGAGAT	DS9
AGGGATGCAAAGAATC	VU
AGGGATGGTCACTGGC	DS6
AGGGATGGTCTGCCAG	DS3
AGGGATGGTTGTCTTT	DS8
AGGGATGTCATCGGAT	DS3
AGGGATGTCCAGAGGA	DS6
AGGGATGTCGCTTGTC	DS6
AGGGATGTCTATGTGG	DS6
AGGGATGTCTGAGGGA	DS8
AGGGTGAAGAAGGACA	DS6
AGGGTGAAGAGAACAG	DS6
AGGGTGACAACACCTA	DS7
AGGGTGACACAGGCCT	DS8
AGGGTGACACAGGTTT	DS6
AGGGTGACACCCATGG	DS3
AGGGTGACAGTAAGCG	DS9
AGGGTGACATGCCCGA	VU
AGGGTGACATGGGAAC	DS7
AGGGTGAGTAGCGCAA	DS8
AGGGTGATCAGCGATT	DS9
AGGGTGATCCCAGGTG	DS7
AGGGTGATCCGTAGTA	DS9
AGGGTGATCGTCTGCT	DS9
AGGGTGATCGTTTATC	DS8
AGGGTGATCTCTTGAT	DS9
AGGTCATAGCACCGTC	DS8
AGGTCATAGCTAAGAT	DS9
AGGTCATAGGTCATCT	DS9
AGGTCATCAAACAACA	DS6
AGGTCATCAAGTAATG	VU
AGGTCATCACTGTGTA	VU
AGGTCATGTCTAGCCG	DS3
AGGTCATGTCTCCACT	DS7
AGGTCATGTGACTACT	DS6
AGGTCATGTTATCCGA	DS7
AGGTCATTCAACGGCC	DS8
AGGTCATTCGCCGTGA	DS9
AGGTCATTCGTTTAGG	DS9
AGGTCATTCTCATTCA	DS3
AGGTCATTCTGTCTCG	DS6
AGGTCCGAGCGATGAC	DS6
AGGTCCGAGGCCGAAT	VU
AGGTCCGCAATCTGCA	DS6
AGGTCCGCAGGTCTCG	DS8
AGGTCCGGTAGCTAAA	VU
AGGTCCGGTCTGGAGA	DS6
AGGTCCGGTGACCAAG	DS6
AGGTCCGGTGGGTATG	VU
AGGTCCGGTGTCAATC	DS9
AGGTCCGGTTCGGGCT	DS9
AGGTCCGTCGAGGTAG	DS6
AGGTCCGTCGCATGGC	DS7
AGGTCCGTCGTTACAG	DS7
AGGTCCGTCTACTATC	DS6
AGGTCCGTCTTATCTG	DS6
AGTAGTCAGAATTGTG	DS7
AGTAGTCAGCGATATA	VU
AGTAGTCCAAGGTTCT	DS6
AGTAGTCCACAGAGGT	DS7
AGTAGTCGTCGTGGCT	DS8
AGTAGTCGTTGATTCG	DS6
AGTAGTCGTTGGACCC	DS6
AGTAGTCTCCGCATCT	DS8
AGTAGTCTCGCCTGTT	DS6
AGTCTTTAGACCACGA	DS8
AGTCTTTAGACGACGT	DS9
AGTCTTTAGCTAAGAT	DS9
AGTCTTTAGGCAATTA	DS6
AGTCTTTCAAGTACCT	DS9
AGTCTTTCACCCATTC	DS6
AGTCTTTCATAGGATA	DS3
AGTCTTTGTACGACCC	DS3
AGTCTTTGTCAACTGT	DS7
AGTCTTTGTCGGATCC	DS6
AGTCTTTGTCTGATTG	DS7
AGTCTTTTCAGAGGTG	DS6
AGTCTTTTCAGGCCCA	DS7
AGTCTTTTCCCAACGG	DS6
AGTCTTTTCCCTAACC	DS3
AGTCTTTTCTAACGGT	VU
AGTGAGGAGCCACCTG	DS3
AGTGAGGAGGTCATCT	VU
AGTGAGGAGGTGACCA	DS9
AGTGAGGAGTAGTGCG	DS3
AGTGAGGCAATCACAC	DS3
AGTGAGGCATACTACG	DS6
AGTGAGGCATGGAATA	DS8
AGTGAGGCATTTCAGG	DS3
AGTGAGGGTCAGAAGC	DS7
AGTGAGGGTCTCCACT	DS9
AGTGAGGGTTCAGACT	DS8
AGTGAGGTCACCTTAT	DS7
AGTGAGGTCGTTTATC	DS8
AGTGAGGTCTTTACGT	DS6
AGTGGGAAGGATATAC	DS6
AGTGGGAAGTGAAGAG	DS8
AGTGGGAAGTGTTGAA	DS8
AGTGGGACACGGACAA	DS7
AGTGGGAGTAATCGTC	DS8
AGTGGGATCAACACGT	DS6
AGTGGGATCAAGCCTA	DS8
AGTGGGATCGCGTTTC	DS8
AGTGGGATCGGAAATA	DS7
AGTGGGATCTATCCCG	VU
AGTGTCAAGATAGTCA	VU
AGTGTCAAGATGCCAG	DS7
AGTGTCAAGGGCACTA	DS9
AGTGTCACACCAACCG	DS6
AGTGTCACACGAAAGC	VU
AGTGTCAGTCTAGTCA	DS9
AGTGTCAGTTAAGGGC	DS8
AGTGTCATCCGAAGAG	DS6
AGTGTCATCCGTAGGC	DS6
AGTGTCATCGACCAGC	VU
AGTGTCATCGCGCCAA	DS6
AGTGTCATCGTAGATC	DS6
AGTGTCATCTGACCTC	DS6
AGTTGGTCAGGGTACA	DS8
AGTTGGTGTAAATGAC	DS6
AGTTGGTGTAAGGGAA	DS8
AGTTGGTGTAGGAGTC	DS6
AGTTGGTGTCAGATAA	DS8
AGTTGGTGTCCGAATT	DS9
AGTTGGTGTCTTGTCC	DS8
AGTTGGTTCCTTGACC	DS7
AGTTGGTTCTGTCTCG	DS8
ATAACGCAGAAACCTA	DS9
ATAACGCCAAGAAAGG	DS6
ATAACGCCACCGTTGG	DS3
ATAACGCCAGCATGAG	DS9
ATAACGCGTCCGAGTC	DS9
ATAACGCGTCTAAACC	DS7
ATAACGCGTGCCTTGG	DS6
ATAACGCGTGGTCTCG	DS6
ATAACGCTCATCGCTC	DS7
ATAACGCTCGGAGGTA	DS9
ATAACGCTCTAACTCT	DS6
ATAACGCTCTCGATGA	DS3
ATAAGAGAGAGTTGGC	DS8
ATAAGAGAGCCATCGC	DS3
ATAAGAGAGCCCAATT	DS7
ATAAGAGAGTAGGTGC	DS9
ATAAGAGAGTGTCTCA	DS3
ATAAGAGTCACAGGCC	DS3
ATAAGAGTCATCGATG	DS6
ATAGACCAGGCTAGAC	DS3
ATAGACCCAAGCTGTT	DS8
ATAGACCCACCGAATT	DS8
ATAGACCGTAATCGTC	DS6
ATAGACCGTCCGTCAG	DS9
ATAGACCGTCGAATCT	DS8
ATAGACCGTGAAATCA	DS8
ATCACGAAGCTAAACA	DS7
ATCACGAAGGGATACC	DS8
ATCACGACAACTGGCC	DS9
ATCACGACAATCCGAT	DS9
ATCACGACACATCCGG	DS6
ATCACGACATAAAGGT	DS9
ATCACGAGTAGCGTCC	DS7
ATCACGAGTCAAAGCG	DS6
ATCACGAGTCCTAGCG	DS7
ATCACGAGTCTGCAAT	VU
ATCACGAGTTCAGTAC	DS7
ATCACGATCCTATGTT	DS9
ATCACGATCTTGAGAC	DS3
ATCATCTAGAGGGATA	DS9
ATCATCTAGGCGACAT	DS6
ATCATCTAGGGTGTTG	DS6
ATCATCTCAGCGTCCA	DS7
ATCATCTGTACAAGTA	DS6
ATCATCTTCACAACGT	DS7
ATCATCTTCATAAAGG	DS6
ATCATCTTCCTATTCA	DS6
ATCATGGAGAAACGCC	DS6
ATCATGGAGACCTAGG	DS8
ATCATGGAGACTAGAT	DS7
ATCATGGAGCTGAACG	DS7
ATCATGGCACAAGTAA	DS8
ATCATGGTCCCTCAGT	DS6
ATCATGGTCCTCAACC	DS3
ATCATGGTCGCTGATA	DS9
ATCCACCAGAGACTTA	DS8
ATCCACCAGCATCATC	DS3
ATCCACCAGCCAACAG	DS9
ATCCACCAGTATCGAA	DS8
ATCCACCCAAAGCGGT	DS8
ATCCACCCAACCGCCA	DS7
ATCCACCGTCTAGCCG	DS6
ATCCACCGTGCACTTA	VU
ATCCACCTCAAGCCTA	DS9
ATCCACCTCATGTAGC	DS9
ATCCACCTCCTGTAGA	DS6
ATCCGAAAGAGCTATA	DS6
ATCCGAAAGCCACCTG	DS3
ATCCGAACAAGTTCTG	DS7
ATCCGAACATTAGGCT	DS7
ATCCGAAGTGCAACTT	DS7
ATCCGAAGTGCCTGTG	DS6
ATCCGAATCCTTCAAT	DS8
ATCGAGTAGACGACGT	DS7
ATCGAGTAGCACAGGT	DS3
ATCGAGTAGCCCAATT	DS3
ATCGAGTAGTGGTCCC	DS7
ATCGAGTTCCATGAGT	DS7
ATCGAGTTCCTCTAGC	DS7
ATCTACTAGATGGGTC	DS6
ATCTACTAGATGTCGG	VU
ATCTACTAGGAGTTTA	DS8
ATCTACTAGTGGGCTA	VU
ATCTACTCAAACCTAC	DS7
ATCTACTCAACACGCC	DS7
ATCTACTCAATAGCGG	DS6
ATCTACTCACAAGCCC	DS6
ATCTACTCACAGGAGT	VU
ATCTACTCACGTAAGG	DS9
ATCTACTCAGTCGTGC	DS8
ATCTACTCATCGATTG	DS6
ATCTACTGTCTAGCCG	DS3
ATCTACTGTTCCGTCT	DS8
ATCTACTTCATGCAAC	DS6
ATCTACTTCCAAGCCG	DS7
ATCTACTTCCGTTGTC	DS3
ATCTACTTCGCATGAT	DS7
ATCTGCCAGACACTAA	DS6
ATCTGCCAGAGTACAT	DS8
ATCTGCCAGGCCCTTG	DS3
ATCTGCCAGTTGAGAT	DS6
ATCTGCCCACAGGTTT	DS9
ATCTGCCCAGCCTTTC	DS6
ATCTGCCGTCTCTCTG	DS8
ATCTGCCGTTAAAGAC	DS8
ATCTGCCTCAGCTCTC	DS9
ATCTGCCTCCTTGGTC	DS7
ATCTGCCTCTGTCAAG	DS7
ATGAGGGAGAATGTGT	DS6
ATGAGGGCAAGTCTAC	DS8
ATGAGGGCAGGAATCG	VU
ATGAGGGGTAGGACAC	DS3
ATGAGGGGTCCAGTTA	DS6
ATGAGGGGTTCGCTAA	DS3
ATGAGGGTCATAACCG	DS8
ATGAGGGTCGGTTCGG	DS7
ATGAGGGTCTTATCTG	DS8
ATGCGATAGTAGGCCA	DS6
ATGCGATAGTAGTGCG	VU
ATGCGATCAATGGTCT	VU
ATGCGATCACATGTGT	VU
ATGCGATCACCGGAAA	DS7
ATGCGATCAGCTGTTA	DS7
ATGCGATGTACCGAGA	DS6
ATGCGATGTAGAGGAA	DS9
ATGCGATTCAGAGACG	VU
ATGGGAGAGCACACAG	DS9
ATGGGAGAGTAAGTAC	DS9
ATGGGAGAGTCGCCGT	DS8
ATGGGAGCAAGCCCAC	DS6
ATGGGAGCAATCTACG	DS3
ATGGGAGCAGTAGAGC	VU
ATGGGAGGTACAGCAG	DS7
ATGGGAGGTGAAATCA	VU
ATGGGAGGTTCGGGCT	DS8
ATGGGAGGTTTGACTG	DS6
ATGGGAGTCAAAGTAG	DS7
ATGGGAGTCAGCACAT	DS6
ATGGGAGTCATGTCTT	DS8
ATGGGAGTCCGTACAA	VU
ATGGGAGTCGGAGGTA	DS6
ATGGGAGTCGGTGTCG	VU
ATGTGTGAGATATGGT	DS8
ATGTGTGAGCGCCTTG	DS7
ATGTGTGAGCGTGTCC	DS8
ATGTGTGAGGGTGTTG	DS6
ATGTGTGAGTGGGTTG	DS7
ATGTGTGAGTTGAGAT	DS6
ATGTGTGGTCCCGACA	DS6
ATGTGTGGTGCTTCTC	DS7
ATGTGTGGTTGCCTCT	DS9
ATGTGTGTCAAGATCC	DS7
ATGTGTGTCACATACG	DS6
ATGTGTGTCAGTGCAT	DS6
ATGTGTGTCCTAGGGC	VU
ATGTGTGTCTTCGGTC	DS7
ATTACTCAGGACGAAA	DS3
ATTACTCAGTACATGA	DS9
ATTACTCGTTCCCGAG	DS8
ATTACTCTCAACGCTA	DS6
ATTATCCAGTAGGTGC	DS6
ATTATCCCACCGTTGG	DS9
ATTATCCCATCAGTAC	DS3
ATTATCCCATTGGGCC	VU
ATTATCCCATTTGCTT	DS6
ATTATCCGTCGCGGTT	DS7
ATTATCCGTGGTAACG	DS6
ATTATCCTCACTCCTG	DS6
ATTATCCTCACTGGGC	DS7
ATTATCCTCCAAATGC	DS7
ATTATCCTCGTGACAT	DS6
ATTCTACAGAACTGTA	DS9
ATTCTACAGAGCAATT	DS6
ATTCTACAGGCGCTCT	VU
ATTCTACCAAACTGCT	DS3
ATTCTACCAAGACGTG	DS8
ATTCTACCACGGTTTA	DS9
ATTCTACCAGCTGCAC	DS3
ATTCTACGTCAACTGT	DS6
ATTCTACTCTGCGACG	DS3
ATTCTACTCTGCTGCT	DS6
ATTGGACAGACACTAA	DS9
ATTGGACAGGACCACA	DS3
ATTGGACCAATGGACG	DS7
ATTGGACCATCGGTTA	DS6
ATTGGACGTAGCGTGA	DS9
ATTGGACGTCTGCGGT	DS8
ATTGGACGTGAGGCTA	DS3
ATTGGACTCGGTTAAC	DS7
ATTGGTGAGGAGTCTG	VU
ATTGGTGCATTTCAGG	DS6
ATTGGTGGTACTTAGC	DS7
ATTGGTGGTATTAGCC	DS3
ATTGGTGGTTCCACTC	DS9
ATTGGTGTCCGTAGGC	DS6
ATTGGTGTCGTCCAGG	DS6
ATTGGTGTCTCTAGGA	DS9
ATTTCTGAGAAGGTTT	VU
ATTTCTGAGTGGAGTC	DS7
ATTTCTGCATATACGC	DS7
ATTTCTGGTAGCAAAT	DS9
ATTTCTGGTAGGGTAC	DS3
ATTTCTGGTCGGGTCT	DS6
ATTTCTGGTGCGAAAC	DS6
ATTTCTGGTGGGTCAA	DS6
CAACCAAAGAGACGAA	DS9
CAACCAAAGAGCAATT	DS9
CAACCAAAGATCCCAT	DS8
CAACCAAAGGCGATAC	DS9
CAACCAAAGTATTGGA	DS6
CAACCAAAGTCCCACG	DS6
CAACCAAAGTTCGATC	DS6
CAACCAACATGCAACT	DS6
CAACCAAGTGCTTCTC	DS6
CAACCAAGTGGTAACG	DS9
CAACCAATCAAGGTAA	DS9
CAACCAATCAATCACG	DS6
CAACCTCAGCATGGCA	DS9
CAACCTCAGCTAAGAT	DS3
CAACCTCAGTACGCGA	DS7
CAACCTCAGTGGTAAT	DS6
CAACCTCCATCTACGA	DS6
CAACCTCGTAAGAGGA	DS6
CAACCTCGTCAATACC	DS7
CAACCTCGTCGAGATG	DS7
CAACCTCGTGCGATAG	DS6
CAACCTCGTGTGGCTC	DS9
CAACCTCGTTAAAGAC	DS6
CAACCTCGTTACGGAG	DS9
CAACCTCTCACAGTAC	DS8
CAACTAGAGATACACA	DS8
CAACTAGAGATCCCAT	DS6
CAACTAGCAAGTACCT	DS7
CAACTAGCAATCCAAC	DS6
CAACTAGCACTATCTT	DS8
CAACTAGCACTCTGTC	DS6
CAACTAGCAGACACTT	DS8
CAACTAGCATCACGAT	DS9
CAACTAGGTCAGTGGA	DS8
CAACTAGGTGCCTGCA	DS8
CAACTAGGTTACGGAG	DS8
CAACTAGGTTCGTCTC	DS3
CAACTAGTCAATACCG	DS6
CAACTAGTCCTAAGTG	DS6
CAACTAGTCCTACAGA	VU
CAACTAGTCGTTGCCT	DS7
CAAGAAAAGCGTGAGT	DS8
CAAGAAAAGGCCCGTT	VU
CAAGAAAAGTAGGCCA	DS7
CAAGAAAAGTCGCCGT	VU
CAAGAAACAAGCCATT	DS9
CAAGAAACAATGGAAT	DS8
CAAGAAACACATGGGA	DS6
CAAGAAACAGCTGTGC	DS6
CAAGAAAGTATGGTTC	DS8
CAAGAAAGTTTGTTTC	DS6
CAAGAAATCCTTTCGG	DS7
CAAGAAATCGATGAGG	VU
CAAGAAATCGCGGATC	DS6
CAAGAAATCTGCTGCT	DS7
CAAGAAATCTGGCGAC	DS6
CAAGAAATCTGGTATG	DS6
CAAGAAATCTGTGCAA	DS8
CAAGAAATCTTGCAAG	DS6
CAAGATCAGAACAACT	DS7
CAAGATCAGGGTATCG	DS9
CAAGATCAGGTTACCT	DS3
CAAGATCCATATGGTC	DS7
CAAGATCCATGCATGT	DS7
CAAGATCGTACAAGTA	DS7
CAAGATCGTACGCACC	DS8
CAAGATCGTACGCTGC	DS6
CAAGATCGTGCGCTTG	DS7
CAAGATCTCCAAACAC	DS9
CAAGATCTCTAACTCT	DS7
CAAGATCTCTCGTTTA	DS9
CAAGGCCAGAGTACCG	DS3
CAAGGCCAGATAGGAG	DS6
CAAGGCCAGCCTTGAT	DS7
CAAGGCCAGGACGAAA	DS6
CAAGGCCAGGCGCTCT	DS8
CAAGGCCAGGCTCTTA	DS8
CAAGGCCAGTAGCCGA	DS7
CAAGGCCAGTGCGTGA	DS8
CAAGGCCAGTGGAGTC	VU
CAAGGCCAGTGTCTCA	DS7
CAAGGCCCAATCTACG	VU
CAAGGCCGTACATCCA	DS6
CAAGTTGAGCCCAACC	DS8
CAAGTTGAGTAAGTAC	DS7
CAAGTTGAGTGTTGAA	DS6
CAAGTTGCAACGATGG	DS9
CAAGTTGCAAGGCTCC	DS8
CAAGTTGCACCAGGTC	DS3
CAAGTTGCACCTCGTT	DS3
CAAGTTGCACGAAATA	DS6
CAAGTTGCATCACCCT	DS3
CAAGTTGCATCGATTG	DS8
CAAGTTGGTCCGAATT	DS7
CAAGTTGGTGTGAATA	DS8
CAAGTTGTCTACTTAC	DS9
CAAGTTGTCTGGTGTA	DS3
CACAAACCAACGCACC	DS9
CACAAACCACGACTCG	DS9
CACAAACCACGCTTTC	DS8
CACAAACCAGTCTTCC	DS8
CACAAACGTAGAGGAA	VU
CACAAACGTGAAAGAG	DS6
CACAAACGTTATTCTC	DS8
CACAAACTCAACGGCC	DS8
CACAAACTCCTCATTA	DS8
CACACAAAGTTGTAGA	VU
CACACAAGTAAACCTC	DS7
CACACAAGTATTCGTG	DS7
CACACAAGTCGCGAAA	DS6
CACACAAGTTTGACAC	DS8
CACACAATCACATACG	DS6
CACACAATCAGTTCGA	DS6
CACACAATCATGGTCA	DS6
CACACAATCGGTCCGA	DS8
CACACCTAGCCAGTAG	DS6
CACACCTAGGGTGTTG	DS3
CACACCTAGTAGGTGC	DS7
CACACCTCAATCAGAA	DS9
CACACCTCACGAAATA	DS3
CACACCTCAGCTGCTG	DS7
CACACCTCAGTCACTA	DS6
CACACCTGTCAAACTC	DS7
CACACCTGTGATAAAC	DS6
CACACCTTCAAGGTAA	DS9
CACACCTTCAGAGGTG	DS6
CACACCTTCCGCGCAA	DS8
CACACCTTCCTCATTA	DS8
CACACCTTCTCTGCTG	VU
CACACTCAGGAGTACC	DS6
CACACTCAGTACCGGA	VU
CACACTCCACCGTTGG	DS6
CACACTCCATACCATG	DS7
CACACTCCATGGAATA	DS7
CACACTCGTAGGCATG	DS6
CACACTCGTGACGCCT	DS6
CACACTCTCAAGGCTT	DS6
CACACTCTCAGGTAAA	DS3
CACACTCTCATGCATG	DS7
CACACTCTCTGCAAGT	DS9
CACAGGCAGCACGCCT	DS9
CACAGGCAGGGATCTG	DS8
CACAGGCCAAGAAGAG	DS3
CACAGGCCAGTAAGAT	DS8
CACAGGCGTATATGAG	DS6
CACAGGCGTCTCTTTA	DS6
CACAGGCGTGTGGCTC	DS7
CACAGGCTCAGCTGGC	DS6
CACAGGCTCATGCTCC	DS8
CACAGGCTCGCCTGTT	DS8
CACAGGCTCTTGTTTG	DS6
CACAGGCTCTTTACAC	DS8
CACAGTAAGGACATTA	DS7
CACAGTAAGTACGATA	DS6
CACAGTAAGTGTACCT	DS6
CACAGTAAGTTAACGA	DS6
CACAGTACAAGGTTTC	VU
CACAGTACAATAACGA	VU
CACAGTACACATGACT	DS3
CACAGTACATCCTTGC	DS7
CACAGTAGTCTCATCC	VU
CACAGTAGTGACAAAT	DS6
CACAGTATCAAGGTAA	VU
CACAGTATCTCAAGTG	VU
CACATAGAGCCGATTT	DS8
CACATAGCATGGGACA	DS9
CACATAGGTAGAGTGC	DS6
CACATAGGTGCCTTGG	DS8
CACATAGGTTCTGGTA	VU
CACATAGTCGGAATCT	DS8
CACATTTAGAATGTGT	DS8
CACATTTAGAGAGCTC	DS7
CACATTTAGAGTACCG	DS6
CACATTTAGCCGGTAA	DS3
CACATTTCACGGTGTC	VU
CACATTTCACGTAAGG	DS7
CACATTTCAGGGTTAG	DS6
CACATTTGTCTAGGTT	DS7
CACATTTGTTAGTGGG	VU
CACATTTTCACAACGT	DS3
CACATTTTCGTTTAGG	DS8
CACCACTAGGATGGAA	DS8
CACCACTGTAACGTTC	DS9
CACCACTGTATTCTCT	DS9
CACCACTGTCAGGACA	DS6
CACCACTGTGACTACT	DS7
CACCACTGTTCGCTAA	DS9
CACCACTGTTGGAGGT	DS6
CACCACTTCTCTTGAT	DS3
CACCAGGAGGTGGGTT	DS6
CACCAGGCACGCATCG	DS3
CACCAGGCATCGGTTA	DS6
CACCAGGGTCGAGATG	DS6
CACCAGGGTTGTCGCG	DS7
CACCAGGTCTCCAGGG	DS3
CACCTTGCAACACCTA	DS8
CACCTTGGTGATGTGG	DS6
CACCTTGTCAGGATCT	DS6
CACTCCAAGCACCGTC	DS9
CACTCCAAGGCATGGT	DS6
CACTCCAAGTGAAGTT	DS9
CACTCCACACCTATCC	DS8
CACTCCACATTGTGCA	DS6
CACTCCAGTGAACCTT	DS7
CACTCCATCTGTTGAG	DS7
CAGAATCAGATCCCAT	DS7
CAGAATCCACGACGAA	DS6
CAGAATCCATCTCGCT	DS3
CAGAATCGTACCTACA	DS6
CAGAATCGTCGCGTGT	VU
CAGAATCGTCGGCATC	DS7
CAGAATCTCAACGAAA	DS3
CAGAATCTCCACGTTC	DS6
CAGAGAGAGAAGGTGA	DS6
CAGAGAGAGACAAGCC	DS8
CAGAGAGAGCCAGGAT	DS6
CAGAGAGAGGCCCGTT	VU
CAGAGAGAGGCCGAAT	DS8
CAGAGAGAGGGTATCG	DS6
CAGAGAGAGGTAGCTG	DS3
CAGAGAGAGTCGCCGT	DS8
CAGAGAGAGTGATCGG	DS6
CAGAGAGCAGACGTAG	DS3
CAGAGAGGTCTCTTTA	DS6
CAGAGAGTCATCTGCC	DS9
CAGAGAGTCCACGACG	DS6
CAGAGAGTCGCAGGCT	DS6
CAGAGAGTCTTGCATT	DS6
CAGAGAGTCTTGTCAT	DS9
CAGATCAAGCGATAGC	DS6
CAGATCAAGCTTATCG	DS7
CAGATCACACTTCTGC	DS3
CAGATCACAGATAATG	DS7
CAGATCAGTATAGGTA	DS3
CAGATCAGTCCGTGAC	VU
CAGATCATCAGCTGGC	DS8
CAGATCATCTGTACGA	DS3
CAGCAGCAGAATGTTG	DS8
CAGCAGCAGAGTAAGG	DS7
CAGCAGCAGCTAGTGG	DS9
CAGCAGCAGTCTCAAC	DS6
CAGCAGCGTCACAAGG	DS8
CAGCAGCGTGAAGGCT	DS3
CAGCAGCGTGTCAATC	VU
CAGCAGCGTTGGTTTG	DS8
CAGCAGCTCCTATGTT	DS9
CAGCATAAGACTAAGT	DS8
CAGCATAAGATCACGG	DS3
CAGCATAAGGACATTA	DS8
CAGCATACAAAGTCAA	DS8
CAGCATACAGGTGCCT	DS7
CAGCATACATGCAATC	DS8
CAGCATACATGTAAGA	DS6
CAGCATAGTACTCAAC	DS8
CAGCATAGTATAGGGC	DS9
CAGCATAGTCCTGCTT	DS7
CAGCATAGTCTCTCTG	DS6
CAGCATAGTGACAAAT	DS8
CAGCATAGTGGACGAT	DS6
CAGCATAGTGTGTGCC	DS3
CAGCATAGTGTTCTTT	DS7
CAGCATATCCTAGAAC	DS6
CAGCATATCGTGGGAA	DS7
CAGCATATCTACTATC	DS8
CAGCCGAAGAATTGTG	DS9
CAGCCGAAGCATGGCA	DS3
CAGCCGAAGCTAGTCT	DS6
CAGCCGAAGTCTCGGC	DS6
CAGCCGAAGTTTCCTT	VU
CAGCCGACATCGGGTC	DS3
CAGCCGAGTCTGCCAG	VU
CAGCCGAGTTGAACTC	DS6
CAGCCGATCAACGGGA	VU
CAGCCGATCATTGCCC	DS6
CAGCCGATCCTGCAGG	VU
CAGCGACAGAATTCCC	DS9
CAGCGACAGCTGATAA	DS8
CAGCGACGTCAGCTAT	VU
CAGCGACGTCCGTGAC	DS6
CAGCGACGTCTGATCA	DS7
CAGCGACGTGCATCTA	DS6
CAGCGACTCAAACGGG	DS8
CAGCGACTCACGCATA	DS8
CAGCGACTCACGGTTA	DS9
CAGCGACTCACTTCAT	DS9
CAGCGACTCTTAGCCC	DS8
CAGCGACTCTTGCAAG	DS8
CAGCTAAAGGCCATAG	DS7
CAGCTAACACGGCGTT	DS6
CAGCTAACAGCTCGCA	DS9
CAGCTAACATGCCCGA	VU
CAGCTAAGTGGTACAG	DS6
CAGCTAATCGCATGGC	DS6
CAGCTAATCGTAGGTT	VU
CAGCTAATCTGAGTGT	DS6
CAGCTGGAGAATGTGT	DS9
CAGCTGGAGACACGAC	DS9
CAGCTGGAGATCCTGT	DS8
CAGCTGGAGATGCCAG	DS7
CAGCTGGAGCAACGGT	VU
CAGCTGGAGCGATGAC	DS3
CAGCTGGCAGACACTT	DS7
CAGCTGGGTAACGACG	DS3
CAGCTGGGTCATCCCT	DS8
CAGCTGGGTGAGTGAC	DS8
CAGCTGGGTTACCGAT	DS9
CAGCTGGGTTAGGGTG	DS8
CAGCTGGGTTGGGACA	DS3
CAGCTGGTCCATGCTC	DS6
CAGCTGGTCTGTCTAT	DS8
CAGGTGCAGCCCAGCT	VU
CAGGTGCAGGGTGTGT	VU
CAGGTGCAGTAACCCT	DS9
CAGGTGCAGTGTCTCA	DS8
CAGGTGCCAATACGCT	DS3
CAGGTGCCACATTAGC	DS6
CAGGTGCCATCATCCC	DS6
CAGGTGCGTCCGACGT	DS3
CAGGTGCGTGAAATCA	DS9
CAGGTGCGTGCAGTAG	VU
CAGGTGCTCTGTTTGT	DS8
CAGTAACAGAGATGAG	DS9
CAGTAACAGCCAGAAC	DS3
CAGTAACCAGGAATCG	DS9
CAGTAACGTCATATGC	DS8
CAGTAACGTCTGATCA	DS7
CAGTAACGTTATCCGA	DS6
CAGTAACGTTCTGAAC	DS6
CAGTAACTCTGAGTGT	DS6
CAGTAACTCTTGACGA	DS8
CAGTCCTAGAATTGTG	DS3
CAGTCCTAGACCTAGG	DS3
CAGTCCTAGACTTTCG	DS3
CAGTCCTAGGAGTTTA	DS9
CAGTCCTAGTGTACGG	DS8
CAGTCCTCAAACTGTC	DS8
CAGTCCTCACCCATGG	DS9
CAGTCCTCAGTCACTA	DS9
CAGTCCTCATATGGTC	DS6
CAGTCCTGTACAGTTC	DS8
CAGTCCTGTATAGGTA	DS6
CAGTCCTGTTCACGGC	DS8
CAGTCCTTCACGGTTA	DS6
CAGTCCTTCCTAAGTG	DS7
CATATGGAGACAAAGG	DS6
CATATGGAGCAGATCG	VU
CATATGGAGTAGGTGC	DS6
CATATGGCAACACCTA	DS6
CATATGGCATCAGTAC	DS6
CATATGGCATTATCTC	VU
CATATGGGTGATAAGT	DS6
CATATGGTCAGTCAGT	DS6
CATATGGTCATACGGT	DS7
CATATTCAGATGCCTT	DS8
CATATTCAGCCAGAAC	DS9
CATATTCAGTGGGCTA	DS6
CATATTCAGTGTACCT	VU
CATATTCCATGTAAGA	DS8
CATATTCGTAAGAGAG	DS7
CATATTCGTGCACCAC	DS6
CATATTCTCAAACCGT	DS3
CATATTCTCAACGGGA	DS8
CATATTCTCAGAGACG	DS6
CATATTCTCGTCCGTT	VU
CATATTCTCTTATCTG	DS3
CATCAAGAGGACTGGT	VU
CATCAAGCACCAGTTA	VU
CATCAAGGTAAATACG	DS8
CATCAAGGTCGGATCC	DS9
CATCAAGGTGAGTGAC	DS6
CATCAAGGTGTAATGA	DS3
CATCAAGTCATAAAGG	DS9
CATCAAGTCCCTCAGT	DS9
CATCAAGTCTTTCCTC	DS9
CATCAGAAGGTAGCCA	DS8
CATCAGAAGTCATCCA	VU
CATCAGAAGTCCATAC	DS8
CATCAGAAGTTGCAGG	DS7
CATCAGACACACCGAC	DS8
CATCAGACACATCTTT	DS6
CATCAGACATGCATGT	DS9
CATCAGAGTAGCTGCC	DS6
CATCAGAGTCATATCG	DS7
CATCAGAGTCCAGTTA	DS8
CATCAGAGTTGAGTTC	DS6
CATCAGATCCTATTCA	DS6
CATCAGATCGGAATCT	DS7
CATCAGATCTGAGGGA	DS6
CATCCACAGAATTCCC	DS6
CATCCACAGGCGATAC	DS3
CATCCACAGGCGCTCT	DS6
CATCCACCAATGGATA	DS9
CATCCACCACGCTTTC	DS8
CATCCACCAGACGCTC	DS6
CATCCACCATCACCCT	DS6
CATCCACCATGCCCGA	VU
CATCCACGTGTTCTTT	DS6
CATCCACGTTGACGTT	DS6
CATCCACTCAAAGTAG	DS3
CATCCACTCCCAAGAT	DS6
CATCCACTCCGTAGTA	DS6
CATCGAAAGCTAGTCT	DS6
CATCGAAAGGACAGAA	VU
CATCGAAAGGCTCATT	DS6
CATCGAACAGCCTATA	DS7
CATCGAAGTCCTGCTT	DS6
CATCGAATCAACCATG	DS7
CATCGAATCACGACTA	DS6
CATCGAATCGCTTGTC	DS6
CATCGAATCTCCCTGA	DS8
CATCGGGAGCGTTGCC	DS9
CATCGGGAGGACGAAA	DS6
CATCGGGAGGCCCGTT	DS7
CATCGGGCAGTAAGCG	VU
CATCGGGCATTCGACA	DS9
CATCGGGGTAGCGTGA	VU
CATCGGGGTGTCTGAT	DS7
CATCGGGTCCTGCTTG	DS7
CATCGGGTCGCGTAGC	VU
CATGACAAGTGGAGAA	DS6
CATGACACACTTCGAA	DS3
CATGACACAGCTGTGC	VU
CATGACACAGTCGATT	DS6
CATGACAGTACAGACG	DS8
CATGACAGTACTTAGC	DS9
CATGACAGTCGCGTGT	DS9
CATGACATCACAATGC	DS6
CATGACATCATATCGG	DS7
CATGCCTAGATGTCGG	DS8
CATGCCTAGCCGCCTA	DS6
CATGCCTAGCTACCGC	DS7
CATGCCTCACACCGCA	DS6
CATGCCTGTAATCGTC	DS6
CATGCCTGTTCTCATT	DS3
CATGCCTTCGATGAGG	DS6
CATGGCGAGACAAAGG	DS9
CATGGCGAGACTAAGT	DS3
CATGGCGAGAGGTTGC	DS9
CATGGCGAGCGCCTTG	DS9
CATGGCGCAAAGGAAG	DS8
CATGGCGCATAGGATA	DS8
CATGGCGGTATTACCG	DS8
CATGGCGGTATTCGTG	DS6
CATGGCGGTCTCCACT	DS6
CATGGCGTCACATACG	DS6
CATGGCGTCATACGGT	DS8
CATGGCGTCATTCACT	DS8
CATGGCGTCCCTGACT	DS6
CATGGCGTCCGCGCAA	DS9
CATGGCGTCCTGCAGG	DS8
CATTATCAGACCTAGG	DS7
CATTATCCAGTGAGTG	DS8
CATTATCCATATACGC	DS6
CATTATCCATGCAACT	DS6
CATTATCCATTGCGGC	DS6
CATTATCGTACAGTTC	VU
CATTATCGTCATATGC	DS8
CATTATCGTCGCCATG	DS7
CATTATCGTGTTTGGT	DS6
CATTATCTCAGTCCCT	DS6
CATTATCTCGGACAAG	DS8
CATTATCTCTGGAGCC	DS9
CATTCGCAGATGGGTC	DS7
CATTCGCAGCGATCCC	DS3
CATTCGCCACTCGACG	DS8
CATTCGCCAGCTCCGA	DS7
CATTCGCGTACTCTCC	DS8
CATTCGCGTCTGCCAG	DS9
CATTCGCTCACATACG	DS3
CATTCGCTCAGAGCTT	DS8
CATTCGCTCAGAGGTG	DS6
CATTCGCTCCTTTCTC	DS6
CATTCGCTCGACGGAA	DS7
CCAATCCAGATATACG	DS7
CCAATCCAGATTACCC	DS7
CCAATCCAGGATGGTC	DS7
CCAATCCAGGCAATTA	DS6
CCAATCCAGGCAGTCA	DS6
CCAATCCAGGGCTTGA	DS7
CCAATCCAGGGTATCG	DS6
CCAATCCAGTTGAGAT	VU
CCAATCCCAATGACCT	DS3
CCAATCCCACATCTTT	DS8
CCAATCCGTCGAGATG	VU
CCAATCCGTGCATCTA	DS9
CCAATCCGTTCGGGCT	DS3
CCAATCCTCACGCGGT	DS6
CCAATCCTCCGCGGTA	DS7
CCAATCCTCTCGATGA	DS3
CCACCTAAGAACTCGG	DS6
CCACCTAAGAGTCTGG	DS9
CCACCTAAGTTCGATC	DS6
CCACCTAAGTTGTCGT	DS6
CCACCTACAGTATGCT	DS6
CCACCTAGTAGCCTAT	DS7
CCACCTAGTAGCTTGT	DS6
CCACCTATCCGCTGTT	DS3
CCACCTATCTGTACGA	DS3
CCACGGAAGCACCGCT	DS7
CCACGGAAGGCCGAAT	VU
CCACGGAAGGGAGTAA	VU
CCACGGAGTATCTGCA	DS6
CCACGGAGTCTAACGT	DS3
CCACGGAGTGAGGGAG	VU
CCACGGATCTTGTCAT	VU
CCACTACAGATGAGAG	DS6
CCACTACAGCTGATAA	DS6
CCACTACAGTAGCGGT	DS3
CCACTACCAAGCCGCT	DS6
CCACTACCAATCAGAA	DS8
CCACTACCATACGCCG	DS8
CCACTACCATCCGGGT	DS6
CCACTACCATCCGTGG	DS3
CCACTACCATCGGACC	DS7
CCACTACCATGACATC	DS8
CCACTACGTCCAGTGC	DS6
CCACTACGTTACGGAG	DS3
CCACTACTCATTATCC	DS8
CCAGCGAAGCGTCAAG	DS6
CCAGCGAAGGTGATAT	DS9
CCAGCGACACGGTTTA	DS7
CCAGCGACAGGAATGC	VU
CCAGCGACATCGACGC	DS8
CCAGCGAGTACTTCTT	DS6
CCAGCGAGTGCTGTAT	VU
CCAGCGATCCTTTCGG	DS7
CCATGTCAGGTAAACT	DS6
CCATGTCCAACTTGAC	DS7
CCATGTCCACAGGAGT	DS8
CCATGTCCACCAACCG	DS6
CCATGTCCACTGAAGG	DS7
CCATGTCGTACCGTTA	DS6
CCATGTCGTATGAATG	DS3
CCATGTCGTCATGCCG	VU
CCATGTCGTCTTCGTC	DS6
CCATGTCGTTAGTGGG	DS9
CCATGTCGTTCAGACT	DS3
CCATGTCGTTGACGTT	DS7
CCATGTCTCAAGGTAA	DS6
CCATGTCTCATCATTC	DS6
CCATGTCTCGAGAACG	VU
CCATGTCTCTTGGGTA	DS6
CCATTCGAGTGCTGCC	DS6
CCATTCGCAGCCACCA	DS8
CCATTCGGTTCCGTCT	DS6
CCATTCGGTTGTTTGG	DS8
CCATTCGTCTGCGTAA	DS8
CCCAATCAGACAAAGG	DS8
CCCAATCAGACAGACC	DS9
CCCAATCAGCGAGAAA	DS6
CCCAATCAGGCCATAG	DS9
CCCAATCAGTCCATAC	DS9
CCCAATCCATCCGGGT	DS6
CCCAATCCATGGGAAC	DS6
CCCAATCGTCCTGCTT	DS6
CCCAATCGTGACTACT	DS6
CCCAATCGTTATCCGA	DS9
CCCAATCTCGTTTATC	DS9
CCCAATCTCTCCCTGA	DS9
CCCAATCTCTGGCGAC	DS6
CCCAGTTAGAATAGGG	DS6
CCCAGTTAGCCGGTAA	DS6
CCCAGTTGTATAATGG	DS7
CCCAGTTGTCATATCG	DS6
CCCAGTTGTGTTTGTG	DS6
CCCAGTTGTTTAGCTG	DS6
CCCAGTTTCCTATTCA	DS3
CCCATACAGTATTGGA	DS7
CCCATACAGTCAAGGC	DS7
CCCATACCATGCCTTC	DS6
CCCATACGTATTACCG	DS3
CCCATACTCAAACCGT	DS8
CCCTCCTAGCTAACTC	DS3
CCCTCCTAGCTGTTCA	DS8
CCCTCCTAGGGTTTCT	DS6
CCCTCCTAGGTGCTAG	DS9
CCCTCCTCAGTGGGAT	DS6
CCCTCCTGTAGTAGTA	DS6
CCCTCCTGTCATCCCT	DS9
CCCTCCTGTCGGCTCA	DS6
CCCTCCTGTGCGATAG	DS7
CCCTCCTGTTACGACT	DS3
CCCTCCTGTTCTCATT	DS6
CCCTCCTTCAGTTGAC	DS7
CCCTCCTTCGGCCGAT	DS8
CCCTCCTTCGTAGGTT	DS6
CCCTCCTTCTGGGCCA	DS6
CCCTCCTTCTGTCAAG	DS6
CCCTCCTTCTGTTGAG	DS6
CCGGGATAGAAGGACA	DS6
CCGGGATAGAGGGCTT	DS8
CCGGGATAGAGTCTGG	DS3
CCGGGATAGCATGGCA	VU
CCGGGATAGTCATCCA	DS7
CCGGGATAGTCGATAA	DS3
CCGGGATCAAGTTCTG	DS8
CCGGGATCAATAAGCA	DS7
CCGGGATCAATCTGCA	VU
CCGGGATCACAGGTTT	DS6
CCGGGATCATTGCGGC	DS7
CCGGGATGTCCGTCAG	DS8
CCGGGATGTGTGACGA	DS6
CCGGGATTCCTGTAGA	DS3
CCGGTAGCACACATGT	DS3
CCGGTAGCACTAAGTC	DS9
CCGGTAGCATGTTCCC	DS6
CCGGTAGGTATAAACG	VU
CCGGTAGGTCATATGC	VU
CCGGTAGGTGATGATA	DS7
CCGGTAGTCATCTGTT	VU
CCGGTAGTCCTCGCAT	DS6
CCGGTAGTCGTGGTCG	DS3
CCGGTAGTCTCTAGGA	DS7
CCGTACTAGAAACCTA	DS6
CCGTACTAGATAGGAG	DS9
CCGTACTAGATGGGTC	VU
CCGTACTAGCGACGTA	VU
CCGTACTAGGCTACGA	DS8
CCGTACTAGTGGTCCC	VU
CCGTACTCAGGCGATA	DS9
CCGTACTCATTTCAGG	DS8
CCGTACTGTCCGACGT	DS6
CCGTACTGTGCAGTAG	DS6
CCGTACTGTGGGTATG	DS6
CCGTACTTCAAAGACA	DS6
CCGTACTTCATCGATG	DS6
CCGTACTTCCAAGTAC	DS6
CCGTACTTCCGTTGCT	DS7
CCGTACTTCTCCTATA	DS8
CCGTACTTCTTTAGGG	DS7
CCGTGGAAGACTTTCG	DS7
CCGTGGACAAGACACG	DS8
CCGTGGACACTGTTAG	DS9
CCGTGGAGTAAGTTCC	DS6
CCGTGGAGTATGGTTC	DS9
CCGTGGAGTGCAGACA	DS3
CCGTGGAGTGCAGGTA	DS6
CCGTGGAGTTCAGTAC	DS7
CCGTGGATCGCATGAT	VU
CCGTGGATCGCGGATC	DS7
CCGTGGATCGGAAATA	DS6
CCGTGGATCGTGACAT	DS6
CCGTTCAAGACTGGGT	DS6
CCGTTCAAGCCTTGAT	DS7
CCGTTCAAGGCCATAG	DS7
CCGTTCACAGATCTGT	DS6
CCGTTCAGTGTGCCTG	DS9
CCGTTCAGTGTGGTTT	DS6
CCGTTCATCAACTCTT	VU
CCTAAAGAGGCACATG	DS8
CCTAAAGAGGGCTTCC	DS9
CCTAAAGAGTATGACA	DS7
CCTAAAGCATGAACCT	DS7
CCTAAAGTCAAAGACA	DS6
CCTAAAGTCGGCTTGG	DS7
CCTAAAGTCTACTATC	DS8
CCTACACAGCGATATA	DS6
CCTACACAGTACGTAA	DS6
CCTACACCACCGAAAG	DS3
CCTACACCAGAGTGTG	DS8
CCTACACCAGCTGCTG	DS8
CCTACACCAGGAACGT	DS3
CCTACACCAGGGTTAG	DS9
CCTACACTCACATACG	DS6
CCTACACTCAGGCGAA	DS7
CCTACACTCATGTAGC	DS6
CCTACACTCTATCCTA	DS6
CCTACACTCTGTCAAG	VU
CCTACCAAGGACACCA	DS8
CCTACCACAAATTGCC	DS6
CCTACCAGTGCTCTTC	DS9
CCTACCAGTTTAGGAA	DS8
CCTACCATCACCGTAA	DS6
CCTACCATCATGTCCC	DS6
CCTACCATCCATGCTC	DS6
CCTACCATCGGTCTAA	DS7
CCTACCATCTGCGGCA	DS9
CCTACCATCTTATCTG	DS8
CCTAGCTAGATGGCGT	DS8
CCTAGCTAGGCCCTTG	VU
CCTAGCTCAACTTGAC	DS6
CCTAGCTCAAGCCGTC	DS9
CCTAGCTCAGTGAGTG	DS7
CCTAGCTGTCTACCTC	DS9
CCTAGCTGTCTCAACA	DS7
CCTAGCTGTGCAACTT	DS6
CCTAGCTGTTCGCTAA	DS3
CCTAGCTTCAACACTG	VU
CCTAGCTTCGACCAGC	DS9
CCTAGCTTCGATCCCT	DS8
CCTATTAAGACTAGAT	DS6
CCTATTACACTGTCGG	DS3
CCTATTACAGGTCTCG	DS8
CCTATTACATCAGTAC	DS6
CCTATTAGTCGGGTCT	DS9
CCTATTAGTTAAGACA	DS6
CCTATTATCGCAAGCC	DS6
CCTATTATCGTAGGTT	DS9
CCTCAGTAGACCGGAT	DS6
CCTCAGTAGATGTGGC	DS9
CCTCAGTAGCGTAGTG	DS6
CCTCAGTAGTGGGTTG	DS6
CCTCAGTCAAGGTGTG	DS8
CCTCAGTCATGTCGAT	DS6
CCTCAGTGTGCTGTAT	DS6
CCTCAGTGTGGTAACG	DS9
CCTCAGTTCAACGCTA	VU
CCTCAGTTCCTAGTGA	DS8
CCTCTGACAAGCGATG	DS8
CCTCTGACAAGTAGTA	DS8
CCTCTGACATCGGACC	DS9
CCTCTGAGTCCGAACC	DS7
CCTCTGATCTGAGGGA	VU
CCTTACGAGAGGACGG	DS8
CCTTACGAGGCGATAC	VU
CCTTACGAGTCCGGTC	DS6
CCTTACGAGTTGAGTA	DS9
CCTTACGCAGCCACCA	DS6
CCTTACGGTACCTACA	DS8
CCTTACGGTCTAGTGT	DS3
CCTTACGGTTCCTCCA	DS6
CCTTACGTCAAACCGT	DS7
CCTTACGTCCTGCTTG	DS6
CCTTACGTCCTGTAGA	DS3
CCTTACGTCTACCTGC	DS8
CCTTCCCAGAATTCCC	DS9
CCTTCCCAGGTGCTAG	DS6
CCTTCCCCAATCAGAA	DS6
CCTTCCCCAGACGCAA	VU
CCTTCCCCAGCGTCCA	DS8
CCTTCCCCATCCCATC	DS8
CCTTCCCCATGCCCGA	DS9
CCTTCCCGTGATAAGT	DS6
CCTTCCCGTTGAGTTC	VU
CCTTCCCTCACAAACC	DS3
CCTTCCCTCATCGCTC	DS6
CCTTCCCTCCGCGTTT	DS7
CCTTCCCTCGGGAGTA	VU
CCTTCGAAGCGTCTAT	DS6
CCTTCGAAGGCCATAG	DS6
CCTTCGACAAGTTGTC	DS6
CCTTCGACACCTATCC	DS9
CCTTCGACAGCATGAG	DS7
CCTTCGACAGGGAGAG	DS9
CCTTCGACATGTCCTC	DS6
CCTTCGAGTCCAGTTA	DS7
CCTTCGAGTCTTTCAT	DS7
CCTTCGAGTGGACGAT	DS6
CCTTCGATCATCTGTT	VU
CCTTCGATCCTATTCA	DS6
CCTTTCTAGGACCACA	DS8
CCTTTCTAGTCTCGGC	DS8
CCTTTCTCAGCATACT	DS8
CCTTTCTCAGTCTTCC	VU
CCTTTCTCATAGGATA	DS7
CCTTTCTCATATGCTG	DS7
CCTTTCTGTCGTCTTC	DS6
CCTTTCTTCCAGGGCT	DS6
CCTTTCTTCCTAGGGC	DS6
CCTTTCTTCCTGTACC	VU
CCTTTCTTCGGAATCT	VU
CGAACATAGCAGGTCA	DS9
CGAACATAGCCCAACC	DS3
CGAACATAGTATCTCG	DS7
CGAACATCACACCGCA	VU
CGAACATCACTAGTAC	DS6
CGAACATGTAAAGTCA	DS6
CGAACATGTAGCGATG	VU
CGAACATGTCCGTTAA	VU
CGAACATGTGACAAAT	DS3
CGAACATGTGATAAGT	DS6
CGAACATTCCAAGCCG	DS9
CGAACATTCCTGCTTG	DS7
CGAACATTCTCAAACG	DS6
CGAATGTAGCAATATG	DS7
CGAATGTAGGTGTTAA	DS9
CGAATGTAGTCGTTTG	DS8
CGAATGTAGTGGTAAT	DS8
CGAATGTCAGTCCTTC	DS9
CGAATGTGTATATCCG	DS3
CGAATGTTCACTCCTG	DS8
CGAATGTTCATATCGG	DS6
CGAATGTTCCAGATCA	DS9
CGAATGTTCGCCAAAT	DS9
CGACCTTAGAGCTATA	DS6
CGACCTTAGCGTAATA	DS9
CGACCTTAGTGTTAGA	DS9
CGACCTTCAAACGTGG	DS6
CGACCTTCACAGACAG	VU
CGACCTTCATCAGTCA	DS8
CGACCTTCATCGGTTA	DS3
CGACCTTCATTCCTCG	DS3
CGACCTTGTCCATCCT	DS6
CGACCTTGTTACCGAT	DS7
CGACCTTTCCATGAGT	DS7
CGACCTTTCCTAAGTG	DS7
CGACCTTTCCTGCAGG	VU
CGACCTTTCGAATCCA	DS6
CGACCTTTCTGATACG	DS7
CGACTTCAGAGATGAG	DS8
CGACTTCAGCCTTGAT	DS8
CGACTTCAGCTAAACA	DS7
CGACTTCAGCTAGTCT	DS8
CGACTTCCAGTGGGAT	DS6
CGACTTCCATAGACTC	DS6
CGACTTCGTACTCAAC	DS3
CGACTTCGTATCGCAT	DS7
CGACTTCGTTGCCTCT	DS7
CGACTTCTCAAAGTAG	DS6
CGACTTCTCGGGAGTA	DS9
CGAGAAGAGGATGGAA	DS6
CGAGAAGCACATCCAA	DS3
CGAGAAGCAGCGATCC	DS9
CGAGAAGCATTTGCCC	DS6
CGAGAAGGTAGGCATG	DS8
CGAGAAGGTAGTGAAT	DS9
CGAGAAGGTGTCTGAT	DS9
CGAGAAGTCACATACG	VU
CGAGAAGTCACCGGGT	DS3
CGAGCACAGCTAGTTC	DS6
CGAGCACAGTTGAGAT	DS7
CGAGCACCACAGACAG	DS8
CGAGCACCACCAGCAC	DS6
CGAGCACCACGAAGCA	DS6
CGAGCACCATATACCG	DS6
CGAGCACGTACCGGCT	DS7
CGAGCACGTGCTAGCC	DS6
CGAGCACTCCTGCAGG	DS9
CGAGCACTCTCTTATG	DS8
CGAGCCAAGACGCTTT	DS6
CGAGCCAAGGATGCGT	DS6
CGAGCCAAGTCAAGGC	DS9
CGAGCCAGTAGCTTGT	DS8
CGAGCCAGTGGTCTCG	DS8
CGAGCCAGTGTGAAAT	DS8
CGAGCCAGTTCCCGAG	DS9
CGAGCCAGTTCTCATT	VU
CGAGCCATCATCTGTT	DS3
CGATCGGAGATGGCGT	DS8
CGATCGGAGCACCGTC	DS7
CGATCGGCAAGCCATT	DS7
CGATCGGCAGATGGGT	DS6
CGATCGGCATCCCACT	DS6
CGATCGGGTCCGAGTC	DS7
CGATCGGGTGCCTGTG	DS8
CGATCGGTCAACCAAC	DS6
CGATCGGTCACCGGGT	DS9
CGATCGGTCGTCGTTC	DS8
CGATGGCAGAGAACAG	DS8
CGATGGCAGCCAACAG	DS3
CGATGGCAGCGAGAAA	DS6
CGATGGCAGGCTATCT	DS8
CGATGGCCAGACGCTC	DS6
CGATGGCGTATTCGTG	DS8
CGATGGCTCCAATGGT	DS8
CGATGGCTCCTCAATT	DS6
CGATGGCTCGAATGCT	DS7
CGATGGCTCGTACCGG	VU
CGATGTAAGCCAGTAG	DS3
CGATGTAAGCTCTCGG	DS6
CGATGTAAGTTTAGGA	VU
CGATGTACACATGTGT	DS8
CGATGTAGTAGGAGTC	DS6
CGATGTAGTCGTTGTA	DS7
CGATGTAGTGCTCTTC	DS8
CGATGTAGTTCGTCTC	DS7
CGATGTATCATCGATG	DS3
CGATGTATCTCACATT	DS3
CGATGTATCTGCTGTC	DS9
CGATGTATCTGGAGCC	DS3
CGATTGAAGAGCCTAG	DS6
CGATTGAAGATGGGTC	DS7
CGATTGAAGCACCGCT	DS8
CGATTGACAACTGCTA	DS9
CGATTGACATAGGATA	DS8
CGATTGACATTCTCAT	DS3
CGATTGAGTACATCCA	DS3
CGATTGAGTAGCGTGA	DS8
CGATTGAGTCACTGGC	DS7
CGATTGAGTCCCGACA	DS3
CGATTGATCACAATGC	DS8
CGATTGATCCCGACTT	DS6
CGATTGATCCTCCTAG	VU
CGATTGATCGCCGTGA	DS3
CGATTGATCGTTTGCC	DS7
CGCCAAGAGCGCCTTG	DS6
CGCCAAGAGGCCGAAT	VU
CGCCAAGAGTACGATA	DS7
CGCCAAGAGTGAAGTT	DS3
CGCCAAGAGTTATCGC	DS6
CGCCAAGCAGAGTGTG	DS7
CGCCAAGCAGTGGGAT	DS7
CGCCAAGGTAAATACG	DS8
CGCCAAGGTACTCTCC	DS8
CGCCAAGGTAGGGACT	DS3
CGCCAAGGTCTGCAAT	VU
CGCCAAGGTGAGGGAG	DS6
CGCCAAGGTTATCACG	DS9
CGCCAAGGTTCACCTC	DS7
CGCGGTAAGGCTAGCA	DS6
CGCGGTACAATAGCAA	DS8
CGCGGTAGTAATCACC	DS3
CGCGGTAGTCATGCCG	DS8
CGCGGTAGTCGCATAT	DS6
CGCGGTATCAGGCGAA	DS3
CGCGGTATCCTATGTT	DS8
CGCGGTATCTGGCGAC	DS6
CGCGTTTAGAAACCGC	DS6
CGCGTTTAGCCAGTTT	DS9
CGCGTTTAGGCTCAGA	DS6
CGCGTTTAGTCGTTTG	DS9
CGCGTTTAGTTACCCA	VU
CGCGTTTCAAAGGCGT	VU
CGCGTTTCAATGAATG	DS7
CGCGTTTCACCAACCG	DS7
CGCGTTTCAGTGGGAT	DS6
CGCGTTTCATAGTAAG	DS6
CGCGTTTGTACCAGTT	DS6
CGCGTTTGTAGATTAG	DS6
CGCGTTTGTGTGAATA	DS9
CGCGTTTGTTCTGTTT	VU
CGCGTTTTCAATCACG	DS8
CGCGTTTTCAGAAATG	DS6
CGCGTTTTCCTTTCGG	DS8
CGCGTTTTCGCGATCG	DS9
CGCGTTTTCTTGCAAG	DS9
CGCTATCAGACTGGGT	VU
CGCTATCAGGCAATTA	DS6
CGCTATCAGGTGATAT	DS6
CGCTATCAGTATCTCG	DS8
CGCTATCGTATATGGA	DS6
CGCTATCGTCGACTGC	DS8
CGCTATCTCAACCATG	DS7
CGCTATCTCAGCTGGC	DS8
CGCTATCTCATCACCC	DS6
CGCTATCTCGTACCGG	VU
CGCTGGAAGCACACAG	DS6
CGCTGGAAGGCATGGT	DS3
CGCTGGAAGGTACTCT	DS3
CGCTGGAAGGTGATTA	DS7
CGCTGGAAGTTTGCGT	DS7
CGCTGGACAAGCTGGA	DS7
CGCTGGACAGGACGTA	DS6
CGCTGGACAGTCCTTC	VU
CGCTGGACATATACCG	DS6
CGCTGGAGTAGCGCTC	DS3
CGCTGGAGTAGTACCT	VU
CGCTGGAGTCATGCCG	DS8
CGCTGGAGTTCCTCCA	DS8
CGCTGGAGTTCGCGAC	DS8
CGCTGGAGTTCGTGAT	DS9
CGCTGGAGTTGAGGTG	DS6
CGCTGGATCCATGAAC	DS6
CGCTGGATCCGTTGCT	DS9
CGCTTCAAGCCCGAAA	DS6
CGCTTCAAGGATGGAA	DS7
CGCTTCAAGTGGGATC	DS8
CGCTTCACACAGAGGT	DS6
CGCTTCACACTGAAGG	DS6
CGCTTCACATTGGCGC	DS7
CGCTTCAGTAGCTTGT	DS8
CGCTTCAGTCAGCTAT	VU
CGCTTCAGTCCTAGCG	DS7
CGCTTCAGTCTAGGTT	DS7
CGCTTCAGTGATAAAC	DS3
CGCTTCAGTGGAAAGA	VU
CGCTTCATCCCTCAGT	DS8
CGGACACAGGGCACTA	DS8
CGGACACCAAACGTGG	DS6
CGGACACCAATGTTGC	DS9
CGGACACCAATTGCTG	VU
CGGACACGTCTCCACT	VU
CGGACACGTGAAGGCT	DS9
CGGACACGTGAGTATA	DS9
CGGACACGTTCGCTAA	DS6
CGGACACTCAGCCTAA	DS7
CGGACACTCGCGTAGC	DS3
CGGACGTAGCCAGGAT	DS6
CGGACGTAGCTAACTC	DS6
CGGACGTAGGATGTAT	DS3
CGGACGTAGGCAATTA	DS3
CGGACGTCAGCTGTTA	DS6
CGGACGTGTACAGTGG	DS7
CGGACGTGTCGGCTCA	DS6
CGGACGTGTTAAAGAC	DS7
CGGACGTTCAGAAATG	DS6
CGGACGTTCCAGTAGT	DS6
CGGACGTTCCGATATG	VU
CGGACGTTCTTCATGT	DS6
CGGACTGAGGAGCGTT	DS6
CGGACTGAGTACACCT	DS9
CGGACTGAGTTGCAGG	VU
CGGACTGGTACGCTGC	DS6
CGGACTGGTATAGGGC	DS3
CGGACTGGTATAGGTA	DS8
CGGACTGGTTAGATGA	VU
CGGACTGTCCCTTGCA	DS7
CGGACTGTCGGCGGTT	DS7
CGGAGCTAGAACTGTA	DS8
CGGAGCTCAAGTTAAG	DS9
CGGAGCTGTACTCTCC	DS3
CGGAGCTGTCTAGCGC	DS9
CGGAGCTGTCTTGCGG	VU
CGGAGCTGTGCAGGTA	VU
CGGAGCTGTTAAGAAC	DS9
CGGAGCTGTTGAGGTG	DS6
CGGAGCTTCACCTCGT	VU
CGGAGCTTCCCAGGTG	DS9
CGGAGCTTCTATCGCC	DS7
CGGAGTCAGAAGGTGA	DS8
CGGAGTCAGCCCAGCT	DS3
CGGAGTCAGCCCTAAT	VU
CGGAGTCAGTACATGA	VU
CGGAGTCCATGAAGTA	DS8
CGGAGTCGTATTCTCT	DS7
CGGAGTCGTTCGTTGA	DS3
CGGAGTCTCACTGGGC	DS3
CGGAGTCTCAGCCTAA	DS7
CGGAGTCTCAGCGATT	DS3
CGGAGTCTCGGCGGTT	DS3
CGGCTAGAGGATCGCA	DS7
CGGCTAGCAACACGCC	DS6
CGGCTAGCAGACAAGC	DS7
CGGCTAGCATCGGACC	DS3
CGGCTAGTCATCTGTT	DS7
CGGCTAGTCTCAAACG	DS8
CGGCTAGTCTGTGCAA	DS3
CGGGTCAAGACAGAGA	DS8
CGGGTCAAGCTCAACT	DS8
CGGGTCAAGTTAAGTG	DS7
CGGGTCACACTTAAGC	DS8
CGGGTCACAGACAAGC	DS8
CGGGTCAGTACCGTAT	DS6
CGGGTCAGTCGGATCC	VU
CGGGTCAGTCTTCTCG	DS6
CGGGTCATCCGCGGTA	VU
CGGGTCATCTGGGCCA	DS3
CGGTTAAAGACTTGAA	DS8
CGGTTAAAGATACACA	DS3
CGGTTAAAGGATTCGG	DS9
CGGTTAAAGTTGCAGG	VU
CGGTTAACACCGAAAG	DS6
CGGTTAACATGCAATC	DS6
CGGTTAACATTTCAGG	VU
CGGTTAAGTAGCGTGA	DS6
CGGTTAAGTCTCTCTG	DS6
CGGTTAATCAGTGTTG	DS7
CGTAGCGAGACTAAGT	DS3
CGTAGCGAGCTAGTTC	DS6
CGTAGCGAGGGATCTG	DS6
CGTAGCGCACCGAATT	DS6
CGTAGCGCAGGAATCG	DS7
CGTAGCGGTCAAGCGA	DS9
CGTAGCGGTCATCCCT	VU
CGTAGCGGTCTAAAGA	DS9
CGTAGCGGTGTAAGTA	DS7
CGTAGCGTCAGTCAGT	DS3
CGTAGCGTCCAAAGTC	DS7
CGTAGCGTCCATGAGT	DS7
CGTAGCGTCCCTGACT	VU
CGTAGGCAGGATGGTC	DS3
CGTAGGCAGGGTGTTG	DS7
CGTAGGCAGTGTGAAT	DS9
CGTAGGCCAAACCTAC	DS8
CGTAGGCCAAGTCTAC	DS9
CGTAGGCCACCATGTA	VU
CGTAGGCGTCACCCAG	DS6
CGTAGGCGTCTAGTCA	DS3
CGTAGGCGTTATTCTC	DS6
CGTAGGCGTTTCGCTC	DS3
CGTAGGCTCCATTCTA	DS9
CGTAGGCTCTTAACCT	VU
CGTCACTAGATGGGTC	DS3
CGTCACTAGCCACTAT	DS3
CGTCACTCAAAGTGCG	DS9
CGTCACTCAATGGTCT	DS3
CGTCACTCACCTCGTT	DS6
CGTCACTCACGCTTTC	DS6
CGTCACTCAGCCAGAA	DS8
CGTCACTCATAGGATA	DS7
CGTCACTGTCACTGGC	DS7
CGTCACTGTCATCCCT	VU
CGTCACTGTGTTCTTT	DS6
CGTCACTGTGTTTGGT	DS3
CGTCAGGAGATCTGAA	DS6
CGTCAGGAGATGCCTT	DS7
CGTCAGGAGCCACGTC	DS8
CGTCAGGAGGCAAAGA	DS8
CGTCAGGAGTAAGTAC	DS6
CGTCAGGAGTGAACAT	DS6
CGTCAGGCAACTTGAC	DS6
CGTCAGGCACGGATAG	DS7
CGTCAGGCAGGGTACA	VU
CGTCAGGCATATACCG	DS8
CGTCAGGCATGTCTCC	VU
CGTCAGGGTACAGTGG	VU
CGTCAGGTCTGCAGTA	DS7
CGTCAGGTCTTATCTG	DS3
CGTCCATAGATGCCAG	VU
CGTCCATAGGAGCGTT	VU
CGTCCATCACAAGACG	DS7
CGTCCATCAGTCAGCC	DS7
CGTCCATCATAACCTG	DS7
CGTCCATGTCACCCAG	DS7
CGTCCATGTCAGAATA	DS6
CGTCCATGTCTCTCTG	DS6
CGTCCATGTTCGCGAC	DS6
CGTCCATTCAGTCCCT	DS6
CGTCCATTCCGGGTGT	DS9
CGTCCATTCGATGAGG	DS9
CGTCCATTCGCCATAA	DS6
CGTCTACAGCTGTTCA	DS8
CGTCTACAGGATTCGG	DS6
CGTCTACAGTTGTCGT	DS9
CGTCTACCATACTCTT	VU
CGTCTACCATCGGTTA	DS7
CGTCTACCATTTCACT	VU
CGTCTACGTACCGAGA	DS8
CGTCTACGTCAAAGAT	DS7
CGTCTACGTGATGCCC	DS7
CGTCTACTCCGTAGGC	DS3
CGTCTACTCGACAGCC	DS6
CGTCTACTCGCCTGAG	VU
CGTGAGCAGAGTGAGA	DS7
CGTGAGCAGCCCAATT	DS3
CGTGAGCAGGACACCA	DS3
CGTGAGCAGGCATGTG	DS3
CGTGAGCAGTACGCCC	DS6
CGTGAGCAGTGATCGG	DS8
CGTGAGCAGTTAAGTG	DS6
CGTGAGCCAAACTGCT	VU
CGTGAGCCACATCCAA	DS7
CGTGAGCGTGCACTTA	DS6
CGTGAGCTCTGTTTGT	VU
CGTGTAAAGAGACGAA	DS6
CGTGTAAAGCCATCGC	DS9
CGTGTAAAGGTTCCTA	DS8
CGTGTAAAGTCATGCT	DS7
CGTGTAAAGTGGTCCC	DS6
CGTGTAACACAGGAGT	DS3
CGTGTAACACTTACGA	DS9
CGTGTAACAGGCTCAC	DS7
CGTGTAAGTCATGCAT	DS9
CGTGTAAGTGAGCGAT	DS3
CGTGTAAGTGTTCGAT	DS9
CGTGTAAGTTCTGTTT	DS6
CGTGTAATCGCCAAAT	DS7
CGTGTAATCGGAAACG	DS7
CGTGTAATCTAAGCCA	DS3
CGTGTCTAGCGTAATA	DS3
CGTGTCTAGCTGCGAA	DS6
CGTGTCTAGGGCTCTC	DS7
CGTGTCTAGTAACCCT	DS3
CGTGTCTAGTACCGGA	DS6
CGTGTCTCAAGCGATG	VU
CGTGTCTCAATGAATG	DS6
CGTGTCTCACAAGACG	DS8
CGTGTCTCACGAAAGC	DS9
CGTGTCTGTAAACCTC	DS9
CGTGTCTGTCAGAGGT	DS6
CGTGTCTGTCCGAAGA	DS3
CGTGTCTGTCGAGTTT	DS6
CGTGTCTTCCGTAGTA	VU
CGTGTCTTCTGACCTC	DS6
CGTGTCTTCTTACCGC	DS8
CGTTAGACAATAGAGT	VU
CGTTAGACACGAAAGC	DS8
CGTTAGACACGCCAGT	DS7
CGTTAGACAGTATCTG	DS6
CGTTAGAGTACGCACC	DS3
CGTTAGAGTCTTGCGG	DS6
CGTTCTGAGTACGCGA	DS6
CGTTCTGCACATTAGC	DS6
CGTTCTGCACCGGAAA	DS6
CGTTCTGCATAGGATA	DS7
CGTTCTGGTCGAACAG	DS3
CGTTCTGTCACCTTAT	DS7
CGTTCTGTCGGATGTT	DS8
CGTTGGGAGGTGGGTT	VU
CGTTGGGCAAGTAGTA	DS7
CGTTGGGCAGCGTTCG	DS9
CGTTGGGCATCCGGGT	VU
CGTTGGGGTCAGAGGT	DS8
CGTTGGGGTCCGTCAG	DS7
CGTTGGGGTGCTCTTC	VU
CGTTGGGGTGGTAACG	VU
CGTTGGGGTTAAGATG	DS7
CGTTGGGGTTCATGGT	DS6
CGTTGGGTCCAGATCA	DS6
CGTTGGGTCGCGATCG	DS9
CTAACTTAGCGATTCT	DS9
CTAACTTCAGACGCTC	DS3
CTAACTTGTCTCCACT	DS9
CTAACTTGTTATCACG	DS7
CTAACTTTCGGATGTT	DS6
CTAACTTTCGTGACAT	VU
CTAAGACAGACCGGAT	DS6
CTAAGACAGCTTATCG	VU
CTAAGACAGGACGAAA	DS6
CTAAGACCAAGACGTG	DS6
CTAAGACCAAGCGTAG	DS9
CTAAGACCAATAGAGT	DS9
CTAAGACCACACCGAC	DS6
CTAAGACCACAGCCCA	DS9
CTAAGACCACGAAATA	DS7
CTAAGACCAGCTCGAC	DS6
CTAAGACCAGCTTAAC	DS6
CTAAGACCATTTCACT	DS9
CTAAGACGTGTAACGG	DS6
CTAAGACTCTTACCGC	DS7
CTAATGGAGCTTTGGT	VU
CTAATGGAGTTTCCTT	DS7
CTAATGGCAATGGAGC	DS8
CTAATGGTCGAGAGCA	DS9
CTACACCAGCTAGCCC	DS3
CTACACCCAAGGACAC	DS3
CTACACCCAGAGCCAA	DS7
CTACACCCAGCTGTTA	VU
CTACACCCAGTCGATT	VU
CTACACCCATGCAACT	DS9
CTACACCCATGGAATA	DS6
CTACACCGTACAAGTA	DS6
CTACACCGTATATGAG	VU
CTACACCGTCTAGCGC	DS6
CTACACCGTCTAGTGT	DS6
CTACACCGTTCCAACA	DS8
CTACACCTCTGCTGTC	DS7
CTACACCTCTGCTTGC	DS3
CTACACCTCTTCCTTC	DS9
CTACATTCAAGACGTG	DS8
CTACATTCACACGCTG	DS9
CTACATTCAGGTCCAC	DS9
CTACATTGTCGGGTCT	DS7
CTACATTGTCTTTCAT	DS9
CTACATTGTGTCAATC	DS7
CTACATTGTGTTCTTT	DS9
CTACATTTCAAGAAGT	DS7
CTACATTTCGGACAAG	DS6
CTACATTTCGTACCGG	DS3
CTACCCAAGCCAGGAT	DS9
CTACCCAAGCCGGTAA	DS3
CTACCCAAGCTGAACG	DS8
CTACCCAAGGCCCGTT	VU
CTACCCAAGGGCTCTC	DS7
CTACCCAAGTCCCACG	VU
CTACCCAAGTGGGTTG	DS8
CTACCCAGTACTTCTT	DS6
CTACCCATCATGTCTT	DS6
CTACGTCAGCGCCTCA	DS7
CTACGTCAGCTGTTCA	DS9
CTACGTCAGGCCGAAT	DS9
CTACGTCAGGTAAACT	DS9
CTACGTCCAAGAGTCG	DS3
CTACGTCCACAGAGGT	DS9
CTACGTCCAGCCTTGG	DS7
CTACGTCCATCGGAAG	DS6
CTACGTCGTAATCACC	DS7
CTACGTCGTGCAACGA	DS3
CTACGTCGTGTTAAGA	DS3
CTACGTCGTTGATTCG	DS6
CTACGTCGTTGGGACA	DS7
CTACGTCTCAACACGT	DS6
CTACGTCTCAGGCAAG	DS8
CTACGTCTCTCCGGTT	DS7
CTAGAGTAGAACAATC	DS8
CTAGAGTAGATCCGAG	DS8
CTAGAGTAGCACGCCT	DS8
CTAGAGTCAAGGACAC	DS7
CTAGAGTCACGGCGTT	DS9
CTAGAGTTCTTGACGA	DS7
CTAGCCTAGATAGCAT	DS3
CTAGCCTAGCTTATCG	DS3
CTAGCCTAGGGAACGG	DS6
CTAGCCTCACATTAGC	DS6
CTAGCCTGTATATGGA	DS3
CTAGCCTGTCCGAATT	DS3
CTAGCCTGTCTTGATG	DS6
CTAGTGAAGCATCATC	DS7
CTAGTGAAGGAATTAC	DS3
CTAGTGACACTGTGTA	VU
CTAGTGACATCAGTCA	DS8
CTAGTGAGTGCAACGA	VU
CTAGTGATCTACTCAT	DS7
CTAGTGATCTGGTTCC	DS6
CTAGTGATCTTCGAGA	DS8
CTAGTGATCTTGCCGT	DS8
CTCACACAGGAACTGC	DS7
CTCACACAGTCGATAA	DS9
CTCACACCAGGTCTCG	DS8
CTCACACCAGTGAGTG	DS6
CTCACACCATAAAGGT	DS7
CTCACACGTGCCTGCA	DS6
CTCACACGTGCCTGTG	DS3
CTCACACGTGGTCCGT	DS9
CTCACACGTTCTGAAC	DS9
CTCACACTCCGAACGC	DS6
CTCAGAAAGCGAAGGG	DS6
CTCAGAACACCATGTA	DS8
CTCAGAAGTCAAAGAT	DS6
CTCAGAAGTCACCCAG	VU
CTCAGAAGTGGTACAG	DS6
CTCAGAATCCTAGTGA	DS7
CTCAGAATCGCGGATC	DS8
CTCATTAAGCCGGTAA	DS9
CTCATTACAAACTGCT	DS9
CTCATTACAATCTGCA	DS3
CTCATTACACCTCGTT	DS8
CTCATTACACGAAATA	VU
CTCATTACACGCCAGT	DS6
CTCATTACAGACGCAA	DS7
CTCATTACATGAAGTA	DS6
CTCATTATCTCATTCA	DS6
CTCCTAGAGACTTGAA	DS8
CTCCTAGCAATGAATG	VU
CTCCTAGCACGGTGTC	DS9
CTCCTAGCAGCTCCGA	VU
CTCCTAGGTCATATGC	DS8
CTCCTAGGTCCAGTGC	DS8
CTCCTAGGTGGAAAGA	VU
CTCCTAGGTTGGAGGT	DS7
CTCCTAGTCCAGGGCT	DS6
CTCCTAGTCGGAGGTA	DS7
CTCCTAGTCGTTGCCT	DS8
CTCCTAGTCTCCTATA	DS8
CTCCTAGTCTTCTGGC	DS3
CTCGAAAGTTAAGGGC	DS3
CTCGAAATCTACTTAC	DS6
CTCGAGGAGAGGTTAT	DS7
CTCGAGGCATTATCTC	DS8
CTCGAGGGTAGCTCCG	DS9
CTCGAGGGTCATATGC	DS9
CTCGAGGGTCCGAATT	DS3
CTCGAGGGTTGACGTT	DS9
CTCGAGGGTTTGTTGG	DS8
CTCGAGGTCATCTGCC	DS9
CTCGGAGAGATGTGTA	DS6
CTCGGAGAGCCACGCT	DS3
CTCGGAGAGCCTTGAT	VU
CTCGGAGAGCTATGCT	DS7
CTCGGAGAGGAATGGA	DS3
CTCGGAGAGTAGGCCA	VU
CTCGGAGCAAATCCGT	DS7
CTCGGAGCACTTACGA	DS9
CTCGGAGCAGCGTCCA	DS8
CTCGGAGCAGGACCCT	VU
CTCGGAGCATGAAGTA	DS3
CTCGGAGGTGTTTGTG	DS6
CTCGGAGTCAACACGT	DS8
CTCGGAGTCAGGCCCA	DS9
CTCGGGAAGAGCTATA	DS6
CTCGGGAAGCACGCCT	DS8
CTCGGGAAGCCCTAAT	DS6
CTCGGGACACAGCGTC	DS3
CTCGGGACAGGAACGT	DS7
CTCGGGACATCAGTCA	DS6
CTCGGGAGTACAGCAG	DS3
CTCGGGAGTCTTTCAT	DS3
CTCGGGAGTGTTTGGT	DS9
CTCGGGAGTTGATTCG	DS9
CTCGGGATCATAGCAC	DS6
CTCGGGATCGCCGTGA	DS3
CTCGGGATCTGGCGTG	DS6
CTCGTACAGGCTCATT	DS6
CTCGTACAGTGACATA	DS8
CTCGTACCACATTAGC	VU
CTCGTACCAGTCGTGC	DS7
CTCGTACCATGCAATC	DS8
CTCGTACCATGTAAGA	DS6
CTCGTACGTAAGAGAG	DS7
CTCGTACGTGACCAAG	DS9
CTCGTACGTGGTGTAG	DS8
CTCGTACGTTTGTTGG	DS8
CTCGTACTCCTTTCTC	DS8
CTCGTACTCTTCGGTC	DS3
CTCGTCAAGACCACGA	DS6
CTCGTCACACTTCTGC	DS8
CTCGTCACATATGGTC	DS8
CTCGTCAGTAAAGGAG	DS6
CTCGTCAGTAGAGTGC	DS9
CTCGTCAGTCAGCTAT	DS7
CTCGTCAGTCTTTCAT	DS9
CTCGTCAGTTATTCTC	DS6
CTCGTCAGTTCGCGAC	DS8
CTCGTCATCAATCTCT	DS7
CTCGTCATCACCACCT	DS6
CTCGTCATCATCTGTT	DS9
CTCGTCATCGCTTGTC	DS3
CTCTAATAGTTAAGTG	DS7
CTCTAATCAGCAGTTT	DS6
CTCTAATCATCAGTAC	VU
CTCTAATGTCGAGTTT	DS6
CTCTAATGTGCGGTAA	DS6
CTCTAATGTGTTTGTG	DS7
CTCTAATGTTCGCTAA	DS6
CTCTAATTCCAGGGCT	DS6
CTCTAATTCGGCATCG	DS7
CTCTACGAGTCCTCCT	DS3
CTCTACGCAACACCTA	DS8
CTCTACGCACTCAGGC	DS7
CTCTACGCATGGATGG	DS6
CTCTACGTCAGCGATT	DS6
CTCTACGTCGATGAGG	DS7
CTCTACGTCGTTTAGG	DS8
CTCTACGTCTCAAACG	DS9
CTCTGGTAGAAGGGTA	DS6
CTCTGGTAGGACATTA	DS3
CTCTGGTAGGGTGTGT	DS6
CTCTGGTCAAGTAGTA	DS6
CTCTGGTCACCATCCT	DS7
CTCTGGTCACCCAGTG	DS3
CTCTGGTCACCTCGGA	DS6
CTCTGGTCACGGTTTA	DS8
CTCTGGTCAGGGTTAG	DS6
CTCTGGTCATAAAGGT	DS8
CTCTGGTCATCCCACT	DS7
CTCTGGTCATTGGCGC	DS7
CTCTGGTGTACGAAAT	DS6
CTCTGGTGTAGAAGGA	DS3
CTCTGGTGTATATGGA	DS3
CTCTGGTGTTATTCTC	DS8
CTCTGGTGTTGAACTC	VU
CTCTGGTTCACCAGGC	DS3
CTCTGGTTCATAGCAC	VU
CTCTGGTTCTATCGCC	DS7
CTGAAACAGGAGCGTT	VU
CTGAAACCAAACGCGA	DS3
CTGAAACCACGTCTCT	DS6
CTGAAACCACTATCTT	DS8
CTGAAACCAGGGATTG	DS8
CTGAAACGTACTCTCC	DS8
CTGAAACGTTCACCTC	DS6
CTGAAACTCAGAGCTT	VU
CTGAAACTCGTTTAGG	DS9
CTGAAACTCTCAACTT	DS6
CTGAAACTCTTGTACT	DS9
CTGAAGTAGCTCTCGG	DS8
CTGAAGTAGGACATTA	DS8
CTGAAGTCAAGCGAGT	DS6
CTGAAGTCAATGACCT	DS3
CTGAAGTCATGTTGAC	DS6
CTGAAGTGTAAGGGCT	DS6
CTGAAGTGTACAGTTC	VU
CTGAAGTGTCTAAAGA	DS6
CTGAAGTGTGATGTGG	DS8
CTGAAGTTCAGGATCT	DS6
CTGATAGAGATAGCAT	DS8
CTGATAGAGCTAGCCC	DS6
CTGATAGAGGCCCTCA	DS8
CTGATAGAGTGCCAGA	DS9
CTGATAGAGTGGTAAT	DS6
CTGATAGAGTTCCACA	DS6
CTGATAGCAGACGCAA	DS3
CTGATAGCAGCGTTCG	DS8
CTGATAGCATAGTAAG	DS9
CTGATAGCATGGATGG	DS9
CTGATAGCATGGTCTA	DS8
CTGATAGCATTGTGCA	DS6
CTGATAGGTGACTACT	DS9
CTGATCCAGTGCTGCC	DS9
CTGATCCCAAGTACCT	DS9
CTGATCCCACGCGAAA	DS9
CTGATCCGTTAAGAAC	DS6
CTGCCTAAGAGCTTCT	DS7
CTGCCTAAGCAAATCA	DS6
CTGCCTACACGAGGTA	DS6
CTGCCTACAGACAAGC	DS6
CTGCCTACAGCTTCGG	DS3
CTGCCTACAGTGGGAT	DS8
CTGCCTACATGCAATC	DS8
CTGCCTAGTGCGATAG	DS6
CTGCCTAGTTTGTTGG	DS6
CTGCCTATCCTATTCA	DS6
CTGCCTATCCTTGGTC	DS9
CTGCGGAAGCTTTGGT	DS7
CTGCGGAAGGGCACTA	VU
CTGCGGACAATGTTGC	DS9
CTGCGGACAGGAATGC	DS6
CTGCGGACATGCTAGT	VU
CTGCGGAGTATGGTTC	DS6
CTGCGGAGTCCAGTTA	DS8
CTGCGGAGTCTACCTC	VU
CTGCGGAGTTCAGCGC	DS7
CTGCGGAGTTCGAATC	DS7
CTGCGGAGTTGGTGGA	DS3
CTGCGGAGTTTGTGTG	DS6
CTGCGGATCAGAGCTT	DS8
CTGCGGATCCTTTCTC	DS3
CTGCGGATCGAGCCCA	DS6
CTGCGGATCGTTGACA	DS6
CTGCGGATCTAAGCCA	DS6
CTGCTGTCACCAACCG	DS6
CTGCTGTCACGTGAGA	DS3
CTGCTGTCAGGGTATG	DS6
CTGCTGTCATTGGCGC	DS7
CTGCTGTGTCGACTGC	DS8
CTGCTGTGTTATCCGA	DS6
CTGCTGTGTTCCTCCA	DS7
CTGCTGTTCTACTCAT	DS7
CTGGTCTAGCCTCGTG	VU
CTGGTCTAGGAGTTGC	DS7
CTGGTCTCAAAGGAAG	DS7
CTGGTCTCAATGAAAC	DS6
CTGGTCTCACAGATTC	DS8
CTGGTCTCACGACGAA	DS9
CTGGTCTCACTAAGTC	DS9
CTGGTCTGTACTTGAC	DS9
CTGGTCTGTAGTGAAT	DS8
CTGGTCTGTTCTGAAC	DS9
CTGGTCTTCAGGTAAA	VU
CTGGTCTTCCCATTTA	DS3
CTGGTCTTCCCTCTTT	DS7
CTGGTCTTCGAATGCT	DS6
CTGGTCTTCTAAGCCA	DS8
CTGTGCTAGTCCATAC	DS9
CTGTGCTCAAACTGTC	DS7
CTGTGCTCAAGGGTCA	DS6
CTGTGCTCAGCCTGTG	DS8
CTGTGCTCAGGCGATA	DS7
CTGTGCTGTCTGCGGT	DS9
CTGTGCTGTGTCGCTG	DS8
CTGTGCTTCACTCTTA	DS6
CTGTGCTTCGCCAAAT	DS6
CTGTTTAAGCCCGAAA	DS9
CTGTTTAAGGCTCAGA	DS7
CTGTTTAAGTACATGA	DS8
CTGTTTACACATTAGC	DS8
CTGTTTACAGCTGCTG	DS8
CTGTTTAGTCAAAGAT	DS3
CTGTTTATCCCACTTG	DS6
CTGTTTATCGTTTGCC	DS8
CTTAACTAGAAGGGTA	DS8
CTTAACTAGACCACGA	DS7
CTTAACTAGCGTGAGT	DS3
CTTAACTAGCTAGTTC	VU
CTTAACTAGTCACGCC	DS9
CTTAACTAGTGTGGCA	VU
CTTAACTCAAGACACG	DS6
CTTAACTCAATCCAAC	VU
CTTAACTCAATGGACG	DS6
CTTAACTCATGCTGGC	DS6
CTTAACTGTACAGCAG	DS8
CTTAACTGTAGCCTAT	DS7
CTTAACTGTAGGCATG	DS8
CTTAACTGTCTAAACC	DS6
CTTAACTGTTTAGGAA	DS6
CTTAACTTCCCGGATG	DS8
CTTAACTTCTGAGGGA	DS3
CTTAACTTCTGGCGAC	DS8
CTTACCGAGAACTGTA	DS9
CTTACCGCAAGCCGCT	DS6
CTTACCGGTACCAGTT	DS6
CTTACCGGTTCCTCCA	DS6
CTTACCGTCACATGCA	DS7
CTTAGGAAGATCCCGC	DS8
CTTAGGAAGCCCAACC	DS9
CTTAGGAAGCTTTGGT	DS3
CTTAGGAAGGATGTAT	DS8
CTTAGGAAGGTCGGAT	DS9
CTTAGGAAGTTGTAGA	DS6
CTTAGGACAATGGAGC	DS6
CTTAGGACAGACTCGC	VU
CTTAGGACAGGGTATG	DS7
CTTAGGACAGTATAAG	DS6
CTTAGGAGTATAGGTA	DS3
CTTAGGAGTCATGCAT	DS8
CTTAGGAGTGTAATGA	DS7
CTTAGGATCACGGTTA	DS8
CTTAGGATCAGTCAGT	DS6
CTTAGGATCCCATTAT	VU
CTTCTCTAGCTGATAA	DS8
CTTCTCTAGGCTAGAC	DS6
CTTCTCTAGTACGCGA	DS7
CTTCTCTAGTGAACGC	DS6
CTTCTCTCAAGGTTTC	DS7
CTTCTCTCACATCCGG	DS8
CTTCTCTCATTAGCCA	DS7
CTTCTCTCATTTCAGG	DS3
CTTCTCTGTCCAGTAT	DS6
CTTCTCTGTGAAGGCT	DS9
CTTCTCTGTTAAGAAC	DS6
CTTCTCTTCATAGCAC	DS9
CTTCTCTTCCTAGGGC	DS8
CTTCTCTTCCTCATTA	DS9
CTTCTCTTCTCCGGTT	DS9
CTTGGCTAGAATCTCC	DS9
CTTGGCTAGCTGCAAG	VU
CTTGGCTCACTAAGTC	DS8
CTTGGCTCAGGTTTCA	DS7
CTTGGCTGTAGCTAAA	DS7
CTTGGCTGTCTCCCTA	DS6
CTTGGCTGTTATCACG	DS7
CTTGGCTTCCTAGTGA	DS6
CTTGGCTTCGCCAAAT	DS6
CTTGGCTTCGGTGTCG	DS9
CTTTGCGAGGGTGTTG	DS7
CTTTGCGAGTCGAGTG	DS6
CTTTGCGCACCAACCG	DS6
CTTTGCGCACGTGAGA	DS9
CTTTGCGCAGGATCGA	DS7
CTTTGCGGTATATGGA	DS8
CTTTGCGGTTATGTGC	DS9
CTTTGCGTCATGTCTT	VU
CTTTGCGTCTGTTTGT	DS8
GAAACTCAGAGGTACC	DS6
GAAACTCAGCTACCGC	DS7
GAAACTCAGTTGAGTA	DS9
GAAACTCCACAACTGT	DS8
GAAACTCCACCCATTC	DS6
GAAACTCCACCTGGTG	DS9
GAAACTCCACTGTTAG	DS8
GAAACTCCAGTGGAGT	DS7
GAAACTCCATCCGGGT	DS9
GAAACTCCATTATCTC	VU
GAAACTCGTCGGCATC	DS7
GAAACTCTCACTCTTA	DS6
GAAACTCTCCGTTGTC	DS9
GAAATGAAGGTGGGTT	DS7
GAAATGACAGACAGGT	DS9
GAAATGACAGGCAGTA	DS7
GAAATGACATCGGAAG	DS8
GAAATGACATTTCACT	VU
GAAATGAGTCCCTACT	DS8
GAAATGAGTTAGTGGG	DS6
GAAATGAGTTGAGGTG	DS9
GAAATGATCTGGGCCA	VU
GAAATGATCTGTTGAG	DS6
GAACATCAGGGCTCTC	DS6
GAACATCAGGTGCACA	DS6
GAACATCCAAGTCATC	DS6
GAACATCCACGGCTAC	DS9
GAACATCGTCCGTCAG	DS9
GAACATCGTGCCTGGT	DS7
GAACATCGTTAGATGA	DS7
GAACATCTCACTTCAT	VU
GAACATCTCATAACCG	DS8
GAACATCTCCAATGGT	DS9
GAACCTAAGAGTCGGT	DS3
GAACCTAAGCCGTCGT	DS6
GAACCTACAGCCTTGG	DS7
GAACCTACAGTGGGAT	VU
GAACCTACATGCATGT	DS6
GAACCTACATTCTCAT	DS8
GAACCTAGTAAAGTCA	DS6
GAACCTAGTCTAGTCA	DS7
GAACCTAGTCTCTTTA	DS6
GAACCTAGTGTTTGTG	VU
GAACCTAGTTCTCATT	VU
GAACCTATCGACAGCC	DS8
GAACGGAAGATCCGAG	DS6
GAACGGAAGCTAGTGG	DS7
GAACGGAAGTTGAGTA	DS6
GAACGGACAAACTGTC	DS3
GAACGGACACTCGACG	DS7
GAACGGACACTGAAGG	DS7
GAACGGACATCAGTCA	DS7
GAACGGAGTACACCGC	DS6
GAACGGAGTCATTAGC	DS7
GAACGGAGTTATGTGC	DS6
GAACGGATCGCGCCAA	DS7
GAACGGATCTTCGGTC	DS8
GAAGCAGAGAAGATTC	DS7
GAAGCAGAGTACCGGA	DS6
GAAGCAGAGTGAATTG	VU
GAAGCAGCAAAGCAAT	DS6
GAAGCAGCAACGATCT	DS6
GAAGCAGGTAAGAGAG	DS7
GAAGCAGGTAATCACC	DS6
GAAGCAGGTCCTGCTT	DS6
GAAGCAGGTGTATGGG	DS7
GAAGCAGGTTAGGGTG	DS7
GAAGCAGGTTCGCTAA	DS8
GAAGCAGGTTTGGCGC	DS6
GAAGCAGTCGTACGGC	DS6
GAAGCAGTCTTGCCGT	DS7
GAATAAGAGATCTGAA	DS6
GAATAAGAGCACGCCT	VU
GAATAAGAGGCCCTTG	DS7
GAATAAGAGGCTATCT	DS6
GAATAAGAGGTCGGAT	DS9
GAATAAGAGGTGTTAA	VU
GAATAAGTCATGTCTT	DS7
GAATAAGTCCTAGAAC	DS8
GAATAAGTCGACCAGC	DS8
GAATGAACACATAACC	DS7
GAATGAACACGAGAGT	DS7
GAATGAACACGTCTCT	DS8
GAATGAACACTGCCAG	DS9
GAATGAACAGGGATTG	VU
GAATGAACAGTATCTG	DS8
GAATGAAGTCAATGTC	DS7
GAATGAATCATTCACT	DS3
GAATGAATCGGTGTTA	DS8
GACACGCAGCAACGGT	VU
GACACGCAGGAATGGA	DS6
GACACGCCAAGAAAGG	DS7
GACACGCCAGCTGGCT	DS7
GACACGCCATCGGTTA	DS3
GACACGCGTACAGTTC	DS3
GACACGCGTCAAAGCG	DS7
GACACGCGTCCTGCTT	DS6
GACACGCTCTATCCTA	DS8
GACAGAGAGACACGAC	DS7
GACAGAGAGACAGGCT	DS9
GACAGAGAGACCCACC	DS9
GACAGAGAGCTACCTA	VU
GACAGAGAGTTAACGA	DS8
GACAGAGCAAGCCGCT	DS9
GACAGAGCAAGTTCTG	VU
GACAGAGCAGAGTGTG	DS6
GACAGAGCAGGACCCT	VU
GACAGAGCAGGGTATG	VU
GACAGAGGTCACAAGG	DS3
GACAGAGGTCGAGATG	DS7
GACAGAGTCATATCGG	DS8
GACAGAGTCGCAAACT	DS6
GACAGAGTCTTATCTG	DS3
GACCAATAGGACGAAA	DS9
GACCAATAGTGTACGG	VU
GACCAATAGTGTCCAT	DS9
GACCAATAGTGTCCCG	DS7
GACCAATCACGCGAAA	DS6
GACCAATCACGCTTTC	DS7
GACCAATCACTTCTGC	DS9
GACCAATGTATCGCAT	DS6
GACCAATGTCAGAGGT	VU
GACCAATGTCTCTCTG	DS9
GACCAATGTTCGAATC	DS6
GACCAATTCCGCGGTA	DS3
GACCAATTCGAGAACG	DS7
GACCAATTCTACTATC	DS8
GACCTGGAGCACGCCT	DS7
GACCTGGAGTCCGTAT	DS6
GACCTGGAGTTAACGA	DS6
GACCTGGCAGTCAGAG	DS3
GACCTGGGTACCGTAT	DS7
GACCTGGGTACGAAAT	DS3
GACCTGGGTAGGCTGA	DS9
GACCTGGGTATGAAAC	DS8
GACCTGGGTTATGCGT	DS9
GACCTGGGTTGTCGCG	DS8
GACCTGGGTTTAAGCC	DS3
GACCTGGTCGCATGGC	DS7
GACCTGGTCGGAAATA	DS9
GACGCGTAGAACTCGG	DS6
GACGCGTAGAGACTTA	DS6
GACGCGTAGCCAGTAG	DS3
GACGCGTAGCTTCGCG	DS3
GACGCGTAGTACGTAA	DS9
GACGCGTCAACACGCC	DS6
GACGCGTCAAGTCATC	DS9
GACGCGTCAATAGAGT	VU
GACGCGTCACAGGTTT	VU
GACGCGTCATAAGACA	DS7
GACGCGTCATCTCCCA	DS7
GACGCGTGTAGCGTCC	DS6
GACGCGTGTCAACATC	DS6
GACGCGTGTCCGAGTC	DS6
GACGCGTGTCGGCATC	VU
GACGCGTGTCTTCTCG	DS6
GACGCGTGTGCTGTAT	DS6
GACGCGTTCACCAGGC	DS3
GACGCGTTCACTCTTA	DS3
GACGCGTTCTAACTGG	DS7
GACGCGTTCTCTTGAT	DS6
GACGCGTTCTGCAAGT	DS3
GACGGCTAGATCCCGC	DS6
GACGGCTAGATGAGAG	DS6
GACGGCTAGGACCACA	DS7
GACGGCTAGGATGGTC	DS6
GACGGCTAGTACCGGA	DS7
GACGGCTCACAAGTAA	DS7
GACGGCTCACACATGT	DS6
GACGGCTCACATCTTT	VU
GACGGCTCAGCTGTTA	VU
GACGGCTCATTCTTAC	DS7
GACGGCTGTCCAGTAT	DS8
GACGGCTGTCTCACCT	DS7
GACGGCTTCAGTTTGG	DS9
GACGGCTTCCGTTGTC	VU
GACGGCTTCGTTTAGG	DS7
GACGTGCAGCCCAGCT	DS6
GACGTGCAGCGTTGCC	VU
GACGTGCAGGGCATGT	DS6
GACGTGCAGGTGCACA	DS3
GACGTGCAGTCCGGTC	DS6
GACGTGCAGTGGGCTA	VU
GACGTGCAGTTAACGA	DS7
GACGTGCAGTTAAGTG	DS8
GACGTGCCAAGTCATC	VU
GACGTGCCAGGCAGTA	DS6
GACGTGCGTCCAGTAT	DS7
GACGTGCGTCTAGCGC	VU
GACGTGCTCCCATTAT	DS7
GACGTGCTCGCGCCAA	DS8
GACGTTAAGCCAGTTT	DS6
GACGTTAAGGGAGTAA	DS8
GACGTTACAGGAATCG	DS9
GACGTTACATGTTGAC	DS6
GACGTTAGTCCCTACT	DS7
GACGTTAGTCCGAGTC	DS3
GACGTTATCAGAGCTT	DS8
GACGTTATCAGAGGTG	VU
GACGTTATCTACCAGA	DS9
GACGTTATCTGCGGCA	DS8
GACGTTATCTTCGAGA	DS6
GACTAACAGTAATCCC	DS8
GACTAACAGTGGGCTA	DS8
GACTAACCATCCTTGC	DS7
GACTAACGTAGGACAC	DS3
GACTAACGTATCGCAT	DS9
GACTAACGTCACCTAA	DS8
GACTAACGTGACGGTA	DS6
GACTAACTCTCAACTT	DS6
GACTACAAGATGTGTA	DS6
GACTACACAACTGCTA	DS6
GACTACACAAGAAGAG	DS6
GACTACACACACATGT	DS9
GACTACACAGCCTATA	DS8
GACTACACATCACGAT	DS6
GACTACAGTAGCACGA	DS8
GACTACAGTCTTTCAT	DS3
GACTACAGTGATAAAC	DS8
GACTGCGAGAAAGTGG	DS3
GACTGCGAGAGCCCAA	DS6
GACTGCGAGAGTCTGG	DS9
GACTGCGAGCTGCAAG	DS6
GACTGCGAGTCCTCCT	DS9
GACTGCGCAAGACGTG	DS8
GACTGCGCAGTCGATT	DS6
GACTGCGCAGTTCATG	DS8
GACTGCGGTCAAACTC	DS7
GACTGCGGTCCGAACC	DS3
GACTGCGGTGCAGGTA	DS9
GACTGCGTCAGGCGAA	DS9
GACTGCGTCCCAAGTA	DS6
GAGCAGAAGGCGCTCT	VU
GAGCAGAAGGTGCTAG	DS3
GAGCAGAAGTCCTCCT	VU
GAGCAGACAAGACACG	DS9
GAGCAGACAATCAGAA	DS6
GAGCAGACATGAACCT	DS8
GAGCAGAGTACTCAAC	DS9
GAGCAGAGTAGCTTGT	DS7
GAGCAGAGTGAGTGAC	DS8
GAGCAGAGTTTGGGCC	DS9
GAGCAGATCATATCGG	DS7
GAGCAGATCATCGATG	DS9
GAGCAGATCGCCTGAG	DS6
GAGCAGATCGGCGCTA	VU
GAGCAGATCGTATCAG	DS9
GAGCAGATCGTTACAG	DS8
GAGGTGACACAGCCCA	DS7
GAGGTGACATCACCCT	DS6
GAGGTGAGTACAAGTA	DS8
GAGGTGAGTATGCTTG	DS8
GAGGTGAGTCAGCTAT	DS6
GAGGTGAGTCGACTAT	DS6
GAGGTGAGTGCTTCTC	DS7
GAGGTGAGTTAAGAAC	DS6
GAGGTGAGTTATTCTC	DS7
GAGGTGATCATGTCCC	DS8
GAGGTGATCTCTGTCG	DS8
GAGTCCGAGAGGGATA	DS7
GAGTCCGAGAGGGCTT	DS7
GAGTCCGAGGGCTCTC	DS8
GAGTCCGCACTCTGTC	DS6
GAGTCCGGTATAATGG	DS8
GAGTCCGTCGCTAGCG	DS9
GATCAGTAGCGATCCC	DS7
GATCAGTAGGTGATAT	DS3
GATCAGTCAAACTGTC	DS9
GATCAGTCACATTCGA	VU
GATCAGTCAGCGTTCG	DS3
GATCAGTGTATTACCG	DS6
GATCAGTGTCAAGCGA	DS3
GATCAGTGTGCAGACA	DS8
GATCAGTTCATCGCTC	DS7
GATCAGTTCGCAAACT	DS6
GATCGATAGAGATGAG	DS6
GATCGATCACGGACAA	DS8
GATCGATCAGACTCGC	DS9
GATCGATCAGCTCGAC	DS9
GATCGATCAGTATAAG	DS6
GATCGATCATCGTCGG	DS7
GATCGATGTAGCGCTC	DS8
GATCGATGTGGGTCAA	DS9
GATCGATGTTGGACCC	DS8
GATCGATTCACCAGGC	DS3
GATCGCGAGGGAACGG	DS6
GATCGCGAGTCTCGGC	DS9
GATCGCGCACAGTCGC	DS8
GATCGCGCACCCATGG	DS3
GATCGCGCACTAGTAC	DS9
GATCGCGCAGACTCGC	DS9
GATCGCGCAGCGATCC	DS7
GATCGCGGTAAATACG	DS6
GATCGCGGTCAGAAGC	DS9
GATCGCGGTCCAGTTA	DS8
GATCGCGGTTCGTCTC	DS6
GATCGCGTCATAAAGG	DS7
GATCGCGTCCGTTGCT	DS3
GATCGCGTCGGATGTT	DS8
GATCGCGTCTGTCTCG	DS6
GATCGTACACGGACAA	DS3
GATCGTAGTAGAGTGC	DS6
GATCGTAGTGGTACAG	DS6
GATCGTAGTGTTTGTG	VU
GATCGTAGTTAAAGAC	DS7
GATCGTATCGTGGACC	VU
GATCTAGAGAACTGTA	DS8
GATCTAGAGTACACCT	DS8
GATCTAGAGTCTCAAC	DS7
GATCTAGCAAGAGGCT	DS6
GATCTAGCACAAGTAA	VU
GATCTAGCACTTCGAA	DS8
GATCTAGCAGCTCGCA	DS7
GATCTAGCAGGTGCCT	DS3
GATCTAGCATAGGATA	DS7
GATCTAGCATATACCG	VU
GATCTAGGTAAGCACG	DS9
GATCTAGGTACTCTCC	DS8
GATCTAGGTGACTCAT	DS8
GATCTAGTCAGCACAT	DS6
GATCTAGTCGATCCCT	DS8
GATCTAGTCGTATCAG	DS8
GATCTAGTCTGCAGTA	DS8
GATGAAAAGACTAAGT	DS8
GATGAAAAGACTTTCG	DS3
GATGAAAAGAGACGAA	DS8
GATGAAAAGTGCGATG	DS3
GATGAAAAGTGGTCCC	DS7
GATGAAACAAACTGCT	DS9
GATGAAACAATCAGAA	DS8
GATGAAACAGATGGGT	DS6
GATGAAAGTAAGTGGC	DS8
GATGAAAGTCCAACTA	DS7
GATGAAAGTCGAACAG	DS9
GATGAAATCAGAGACG	DS7
GATGAAATCAGCATGT	DS6
GATGAAATCCCAAGTA	DS8
GATGAAATCCGAAGAG	DS7
GATGAGGAGAACAATC	DS7
GATGAGGAGCGCTCCA	DS6
GATGAGGAGTTTGCGT	VU
GATGAGGCACCAGGTC	DS6
GATGAGGCACTGTTAG	DS8
GATGAGGCATGTAAGA	DS3
GATGAGGGTGTCGCTG	DS9
GATGAGGTCACATGCA	DS6
GATGAGGTCCCATTAT	DS9
GATGAGGTCGCCAAAT	VU
GATGAGGTCTAGAGTC	DS9
GATGAGGTCTCGTTTA	DS7
GATGAGGTCTGCGACG	DS8
GATGAGGTCTGGTATG	VU
GATGCTAAGACATAAC	DS6
GATGCTAAGACTGTAA	DS3
GATGCTAAGATGCCAG	DS9
GATGCTAAGGATGCGT	DS6
GATGCTAAGTTAAGTG	DS8
GATGCTACACGGTGTC	VU
GATGCTACAGCTGTAT	DS9
GATGCTACATAGACTC	DS8
GATGCTACATGGTAGG	DS6
GATGCTACATTTGCTT	DS7
GATGCTAGTAGGGTAC	DS8
GATGCTAGTCCGCTGA	DS6
GATGCTATCACAGGCC	DS8
GATGCTATCACGCGGT	DS8
GATGCTATCGCCAGCA	DS8
GATGCTATCTCAAGTG	DS6
GATGCTATCTCCAACC	DS3
GATGCTATCTTCGAGA	DS6
GATGCTATCTTGTCAT	DS7
GATTCAGAGCGTCTAT	DS9
GATTCAGCAATGGAGC	DS8
GATTCAGCACATGACT	DS6
GATTCAGCACCCAGTG	DS3
GATTCAGGTTGACGTT	DS6
GATTCAGGTTGAGGTG	DS8
GATTCAGGTTGGTGGA	DS6
GATTCAGTCAAACCAC	DS8
GATTCAGTCAGCTTAG	VU
GCAAACTAGTTACCCA	VU
GCAAACTCAAACTGTC	DS9
GCAAACTCACCATGTA	DS6
GCAAACTCAGTTAACC	DS8
GCAAACTCATGACATC	DS6
GCAAACTCATTAGGCT	DS6
GCAAACTGTCAAAGCG	DS7
GCAAACTGTCAACATC	DS7
GCAAACTGTCTAGCCG	DS9
GCAAACTTCGCCGTGA	DS6
GCAAACTTCTGCAAGT	DS7
GCAATCAAGATGTCGG	DS6
GCAATCAAGGGCTTGA	DS3
GCAATCAAGTGAAGTT	DS8
GCAATCACACAACGCC	DS7
GCAATCACACGAAATA	DS7
GCAATCACAGGACGTA	DS8
GCAATCACAGGCTGAA	DS7
GCAATCACATAGGATA	DS6
GCAATCAGTCGACTGC	DS7
GCAATCAGTCTCCACT	DS8
GCAATCATCCAAGTAC	DS9
GCACATAAGAACAATC	DS8
GCACATAAGCCCTAAT	DS7
GCACATAAGCCGATTT	DS7
GCACATAAGGGCTTCC	DS7
GCACATAAGTATTGGA	DS8
GCACATACAATGAATG	DS7
GCACATACAATTCCTT	DS7
GCACATACAGAGCCAA	DS8
GCACATACATCACCCT	DS3
GCACATACATGGTCTA	DS6
GCACATAGTGTTAAGA	DS9
GCACATAGTGTTGGGA	DS9
GCACATAGTTAAGTAG	DS7
GCACATATCAGAGACG	VU
GCACTCTAGATCCGAG	DS7
GCACTCTAGTCACGCC	DS7
GCACTCTCAAACCTAC	DS6
GCACTCTCACATTTCT	DS7
GCACTCTCATCGATTG	DS6
GCACTCTGTACGACCC	VU
GCACTCTGTAGCTCCG	DS8
GCACTCTGTGCGGTAA	VU
GCACTCTGTTACTGAC	DS3
GCACTCTTCACTCTTA	VU
GCACTCTTCCTTGACC	DS7
GCACTCTTCTGTTGAG	DS3
GCAGCCAAGAGAGCTC	DS7
GCAGCCAAGCGTGAAC	DS7
GCAGCCAAGGGCTTGA	DS8
GCAGCCAAGTGGAGTC	DS6
GCAGCCACACTGTTAG	DS7
GCAGCCACAGATCGGA	DS7
GCAGCCACATTTGCCC	DS7
GCAGCCAGTAAGAGGA	DS8
GCAGCCAGTAAGGATT	DS7
GCAGCCAGTAAGTAGT	DS7
GCAGCCAGTTGCGCAC	DS8
GCAGCCAGTTGGTAAA	DS8
GCAGCCATCAGCTCTC	DS7
GCAGCCATCCAAACTG	DS6
GCAGCCATCCAGTAGT	DS7
GCAGCCATCCGAACGC	DS7
GCAGCCATCCTTCAAT	DS7
GCAGCCATCGTACGGC	DS6
GCAGCCATCTAAGCCA	DS8
GCAGCCATCTCCCTGA	DS7
GCAGTTAAGGTGTTAA	DS8
GCAGTTACACTCAGGC	DS7
GCAGTTAGTACTCGCG	DS6
GCAGTTAGTCAAACTC	DS9
GCAGTTAGTGATGATA	DS7
GCAGTTAGTGTAATGA	VU
GCAGTTAGTTTAGGAA	DS8
GCAGTTATCATCTGCC	DS7
GCAGTTATCCCAAGAT	DS7
GCAGTTATCCGGGTGT	DS7
GCAGTTATCGGAAATA	DS8
GCATACAAGAAGAAGC	DS9
GCATACAAGACTTGAA	DS7
GCATACACACCCTATC	DS8
GCATACACATCGATTG	DS6
GCATACAGTAAACACA	DS6
GCATACAGTTCTGAAC	DS6
GCATACAGTTTGTGTG	DS6
GCATACATCGGATGTT	DS3
GCATGATAGACCTTTG	DS9
GCATGATAGGGTCGAT	DS6
GCATGATAGGGTGTTG	DS9
GCATGATGTATCTGCA	DS6
GCATGATTCACAGGCC	DS3
GCATGATTCCTATTCA	VU
GCATGATTCTATCCCG	VU
GCATGCGAGACAATAC	VU
GCATGCGAGATCCCGC	VU
GCATGCGAGCTCAACT	DS7
GCATGCGAGTGCCATT	DS8
GCATGCGCACAACGTT	DS6
GCATGCGCACAGGTTT	DS9
GCATGCGCACCATCCT	DS3
GCATGCGCACCGCTAG	DS8
GCATGCGCATCACGAT	DS8
GCATGCGCATGAACCT	DS8
GCATGCGCATGCTAGT	DS9
GCATGCGGTATCGCAT	DS3
GCATGCGGTCTGCAAT	VU
GCATGCGTCCTATTCA	VU
GCATGCGTCGATAGAA	DS8
GCATGCGTCGGCTACG	DS7
GCATGTAAGCCTATGT	DS7
GCATGTAAGCGACGTA	VU
GCATGTAAGTCAATAG	DS6
GCATGTAAGTGCCATT	DS8
GCATGTACAAGGTTTC	DS3
GCATGTACAATGGACG	DS9
GCATGTACACAAGTAA	DS7
GCATGTACATTAGCCA	DS6
GCATGTAGTTCCTCCA	DS7
GCATGTATCCCATTAT	DS8
GCCAAATAGGCGACAT	DS8
GCCAAATAGTGAATTG	DS6
GCCAAATAGTTGAGTA	DS6
GCCAAATAGTTGCAGG	VU
GCCAAATCATCTCCCA	DS8
GCCAAATGTGATAAGT	DS6
GCCAAATGTTCCGTCT	DS3
GCCAAATGTTCTGAAC	DS7
GCCAAATGTTGTGGCC	VU
GCCAAATTCGTTTATC	VU
GCCTCTAAGAAAGTGG	VU
GCCTCTAAGATAGTCA	DS6
GCCTCTACAATAAGCA	DS7
GCCTCTAGTCCAACTA	DS6
GCCTCTAGTCCTAGCG	DS8
GCCTCTAGTCGTGGCT	DS9
GCCTCTAGTGGTACAG	DS6
GCCTCTAGTTCACCTC	DS8
GCCTCTAGTTCAGTAC	DS7
GCCTCTAGTTCGGCAC	DS6
GCGACCAAGATGTCGG	DS6
GCGACCAAGGATCGCA	DS8
GCGACCAAGGGCATGT	DS7
GCGACCAAGTCCATAC	DS8
GCGACCAAGTGCAAGC	VU
GCGACCACATGCCTTC	DS8
GCGACCAGTACGAAAT	DS7
GCGACCAGTAGTGAAT	DS6
GCGACCAGTATAATGG	DS6
GCGACCAGTATTAGCC	DS9
GCGACCAGTGACCAAG	DS9
GCGACCATCAGCCTAA	DS7
GCGACCATCAGCTCTC	DS6
GCGACCATCAGTCCCT	DS6
GCGAGAAAGATACACA	DS7
GCGAGAACAAACTGCT	DS8
GCGAGAACAATCGAAA	DS3
GCGAGAACATCACGTA	DS9
GCGAGAATCACTTACT	DS9
GCGAGAATCCCAAGAT	DS6
GCGAGAATCGATCCCT	DS6
GCGCAACCATCGGTTA	VU
GCGCAACGTTCCACTC	DS6
GCGCAACTCAAGGTAA	DS8
GCGCAACTCGATGAGG	DS3
GCGCAACTCTCCGGTT	DS7
GCGCAACTCTGTCTCG	DS8
GCGCAGTAGCGAGAAA	DS7
GCGCAGTAGTGTTGAA	DS3
GCGCAGTAGTTGAGTA	DS7
GCGCAGTCAAGTCATC	DS8
GCGCAGTCACATGACT	DS9
GCGCAGTCAGCCTTGG	DS7
GCGCAGTCATCGATGT	DS6
GCGCAGTTCCGAATGT	DS7
GCGCAGTTCCGCATCT	DS8
GCGCAGTTCTGTTTGT	DS7
GCGCCAAAGAATGTTG	DS9
GCGCCAAAGTGAAGTT	DS8
GCGCCAAGTCCATCCT	DS7
GCGCCAAGTTGATTGC	DS3
GCGCCAATCGGTCTAA	DS9
GCGCCAATCTTGAGAC	DS6
GCGCGATAGAAACGCC	VU
GCGCGATAGCTCAACT	DS6
GCGCGATAGGCTCAGA	DS6
GCGCGATAGGTGCTTT	DS6
GCGCGATAGTGTTTGC	VU
GCGCGATCACGGATAG	DS9
GCGCGATGTTACGCGC	DS9
GCGCGATTCAAGCCTA	DS6
GCGCGATTCACCGTAA	DS6
GCGCGATTCACGCATA	DS3
GCGCGATTCAGAGACG	DS6
GCGCGATTCATTGCGA	DS8
GCGCGATTCCACTGGG	DS8
GCGCGATTCGGTTCGG	VU
GCGCGATTCTGCTGTC	DS8
GCGGGTTAGAAACCTA	DS8
GCGGGTTAGACAGAGA	DS6
GCGGGTTAGTGTTGAA	DS8
GCGGGTTAGTTAGGTA	DS8
GCGGGTTCAGTCACTA	DS3
GCGGGTTCATCTGGTA	DS6
GCGGGTTGTATATCCG	DS7
GCGGGTTGTCAAGCGA	DS7
GCGGGTTGTGGCCCTA	DS7
GCGGGTTGTTGTGGAG	DS9
GCGGGTTTCAGAGCTT	DS7
GCGGGTTTCGCGATCG	DS8
GCGGGTTTCTGTACGA	DS7
GCTCCTAAGAACTCGG	DS8
GCTCCTAAGGCACATG	DS3
GCTCCTACAAACAACA	DS6
GCTCCTACAACTGGCC	DS3
GCTCCTACAAGAAGAG	VU
GCTCCTACACCAGGCT	DS7
GCTCCTACAGTTAACC	DS3
GCTCCTACATAGACTC	DS7
GCTCCTACATGCAATC	DS9
GCTCCTAGTCTCTTAT	DS6
GCTCCTAGTGAACCTT	DS9
GCTCCTAGTTACTGAC	DS8
GCTCCTAGTTGGACCC	DS3
GCTCCTATCAAACCGT	VU
GCTCCTATCTACGAGT	DS6
GCTCCTATCTGTCTCG	DS6
GCTCTGTAGAGTCGGT	DS6
GCTCTGTAGATCACGG	DS6
GCTCTGTAGGGATGGG	VU
GCTCTGTAGTACATGA	DS7
GCTCTGTTCAACACCA	VU
GCTCTGTTCCACGTTC	DS8
GCTGCAGAGATGCGAC	DS7
GCTGCAGAGGATTCGG	DS9
GCTGCAGCACCGAATT	DS6
GCTGCAGCAGTATCTG	VU
GCTGCAGCATCCTTGC	DS3
GCTGCAGGTAACGCGA	DS8
GCTGCAGGTAGGAGTC	DS7
GCTGCAGGTGTGACGA	DS9
GCTGCAGGTTCCTCCA	DS6
GCTGCAGTCATCGATG	DS9
GCTGCAGTCCACGACG	VU
GCTGCAGTCCGCTGTT	DS8
GCTGCAGTCGTATCAG	DS6
GCTGCAGTCTTGGGTA	DS8
GCTGCGAAGAGCTGGT	DS6
GCTGCGAAGAGTCGGT	DS7
GCTGCGAAGATCCTGT	DS6
GCTGCGAAGGCACATG	DS7
GCTGCGACACCGATAT	DS8
GCTGCGAGTAGCGCAA	VU
GCTGCGAGTAGTGAAT	DS3
GCTGCGAGTGGCGAAT	DS6
GCTGCGATCTCGTTTA	DS8
GCTGCTTAGACCTTTG	DS6
GCTGCTTAGAGGACGG	DS7
GCTGCTTAGATAGTCA	DS3
GCTGCTTAGGTGATAT	DS8
GCTGCTTAGTGGGCTA	DS9
GCTGCTTCAAGCTGTT	DS8
GCTGCTTCACGCCAGT	DS7
GCTGCTTGTATGAAAC	DS9
GCTGCTTGTCTCTCGT	DS3
GCTGCTTGTCTGGAGA	VU
GCTGCTTTCACTTATC	DS3
GCTGCTTTCAGGTTCA	DS6
GCTGCTTTCTTTACAC	VU
GCTGGGTAGTCACGCC	VU
GCTGGGTCACATTAGC	DS8
GCTGGGTTCACCGGGT	DS7
GCTGGGTTCGCTTAGA	DS7
GCTGGGTTCGTTACGA	DS6
GCTGGGTTCGTTTAGG	DS7
GCTGGGTTCTGTTGAG	VU
GCTTCCAAGAATGTGT	DS6
GCTTCCAAGATCTGCT	DS7
GCTTCCAAGCCGATTT	DS6
GCTTCCAAGCTCCTCT	VU
GCTTCCACAAGTCATC	DS9
GCTTCCACAGTAACGG	VU
GCTTCCACATGGATGG	DS9
GCTTCCAGTAACGACG	DS8
GCTTCCAGTACCGTTA	DS3
GCTTCCATCACTCCTG	DS6
GCTTCCATCATAGCAC	DS7
GCTTCCATCCGCGCAA	VU
GCTTGAAAGAGCTGCA	VU
GCTTGAAAGTAGCGGT	DS9
GCTTGAAAGTGATCGG	DS3
GCTTGAACAATCTACG	DS8
GCTTGAACAGGTGCCT	DS7
GCTTGAACAGTAACGG	VU
GCTTGAACATCCGTGG	VU
GCTTGAACATGGGACA	DS7
GCTTGAAGTGGCCCTA	DS6
GCTTGAATCCCTTGCA	DS3
GCTTGAATCCTAGTGA	VU
GGAAAGCAGAGGTTAT	DS6
GGAAAGCAGATGCGAC	DS6
GGAAAGCAGGGTTTCT	DS3
GGAAAGCCAAGCCGCT	DS3
GGAAAGCCACGGATAG	DS9
GGAAAGCCACGGTAAG	DS7
GGAAAGCCACGGTAGA	DS3
GGAAAGCCAGGAATCG	DS7
GGAAAGCCATTCTTAC	VU
GGAAAGCGTCCGTCAG	DS3
GGAAAGCGTCTGGTCG	DS6
GGAAAGCGTCTTCGTC	DS3
GGAAAGCGTGTAACGG	DS3
GGAAAGCGTTAAGACA	DS3
GGAAAGCTCACATAGC	DS8
GGAAAGCTCAGGATCT	DS7
GGAAAGCTCATGTCTT	DS9
GGAAAGCTCCCTCAGT	DS6
GGAACTTAGGGTGTGT	DS6
GGAACTTCAAGAAGAG	DS6
GGAACTTCACCACCAG	VU
GGAACTTGTCAACATC	DS9
GGAACTTGTCGACTGC	DS9
GGAACTTGTCTCGTTC	DS6
GGAACTTTCCCTCAGT	DS7
GGAACTTTCGTAGATC	DS7
GGAATAAAGATATGCA	DS9
GGAATAACACAAGCCC	DS6
GGAATAACACACATGT	DS6
GGAATAACACCTCGTT	VU
GGAATAAGTATCGCAT	VU
GGAATAAGTCATATGC	DS7
GGAATAAGTCCCTTGT	DS8
GGAATAATCAAGCCTA	DS6
GGAATAATCACAAACC	DS6
GGAATAATCTACGAGT	DS9
GGACAAGAGGTGCAAC	DS7
GGACAAGAGTGCGTGA	DS6
GGACAAGCACAGGTTT	DS9
GGACAAGCATACCATG	VU
GGACAAGGTGGCAAAC	DS9
GGACAAGTCGCACTCT	DS9
GGACAAGTCGGATGTT	DS7
GGACAAGTCTGATTCT	DS9
GGACAGAAGACGCTTT	VU
GGACAGAAGAGTACAT	DS6
GGACAGAAGCCGGTAA	DS3
GGACAGACATCTACGA	DS6
GGACAGAGTACTCGCG	VU
GGACAGAGTAGCGCTC	DS8
GGACAGAGTCGGGTCT	DS3
GGACAGAGTTCCACTC	DS7
GGACAGAGTTCTGAAC	DS7
GGACAGATCATCGATG	DS6
GGACAGATCCACGACG	DS6
GGACAGATCCTAGAAC	DS8
GGACAGATCCTGCAGG	DS7
GGACAGATCGCAAGCC	DS6
GGACAGATCTTGCAAG	DS3
GGACATTAGAGTTGGC	DS3
GGACATTAGTCTCGGC	DS9
GGACATTCACTCGACG	DS7
GGACATTCAGGATCGA	DS6
GGACATTCAGTATGCT	DS6
GGACATTGTACTTAGC	DS3
GGACATTGTAGCGCTC	VU
GGACATTGTCCAACTA	DS6
GGACATTGTGGCAAAC	DS9
GGACATTTCAGGTTCA	DS6
GGACATTTCATAACCG	DS7
GGACATTTCTTACCGC	DS9
GGACATTTCTTGTTTG	DS7
GGACGTCAGAATGTGT	DS9
GGACGTCAGACTTTCG	DS6
GGACGTCAGATGTGGC	DS6
GGACGTCAGCTCTCGG	DS7
GGACGTCAGGCATGTG	DS6
GGACGTCAGGGATGGG	DS8
GGACGTCAGTAGCGGT	DS6
GGACGTCAGTTGCAGG	DS3
GGACGTCCAAATTGCC	VU
GGACGTCCAATTCCTT	DS7
GGACGTCCACTAAGTC	VU
GGACGTCCAGACGCCT	DS8
GGACGTCCATGTTGAC	DS3
GGACGTCGTAGTGAAT	DS6
GGACGTCGTGTAATGA	VU
GGACGTCGTTCAGCGC	DS3
GGACGTCTCATCGCTC	DS9
GGACGTCTCCGCAGTG	DS6
GGACGTCTCTAAGCCA	DS8
GGAGCAAAGAAGGCCT	DS6
GGAGCAAAGCCACGTC	DS7
GGAGCAAAGCCAGAAC	DS6
GGAGCAAAGCTAGTGG	DS3
GGAGCAAAGGACTGGT	DS6
GGAGCAAAGTACGATA	DS7
GGAGCAACAACACCTA	DS8
GGAGCAACACCAACCG	DS7
GGAGCAACAGACACTT	DS7
GGAGCAAGTACAGACG	DS9
GGAGCAAGTCGCTTTC	DS7
GGAGCAAGTCTCTTAT	DS3
GGAGCAAGTTGAGTTC	DS8
GGAGCAATCAACGGGA	DS3
GGAGCAATCCAGAGGA	DS6
GGAGCAATCGCGGATC	DS6
GGATGTTAGAAACGAG	DS6
GGATGTTAGAGAACAG	DS7
GGATGTTCAAACCCAT	DS3
GGATGTTCAAATTGCC	VU
GGATGTTCAACAACCT	DS3
GGATGTTCAGTTTACG	DS6
GGATGTTGTAATAGCA	DS8
GGATGTTGTAGCTTGT	DS7
GGATGTTTCCAAAGTC	DS7
GGATGTTTCCGTTGTC	DS8
GGATGTTTCGTTACAG	DS7
GGATTACAGAAGGCCT	DS6
GGATTACAGACTAGGC	DS9
GGATTACAGATCGGGT	VU
GGATTACAGCACGCCT	DS6
GGATTACAGCCGTCGT	DS7
GGATTACAGGTGCTTT	DS7
GGATTACAGGTGGGTT	DS7
GGATTACAGTGGAGTC	DS8
GGATTACAGTGGTCCC	DS6
GGATTACCAACAACCT	DS8
GGATTACCAAGACACG	DS9
GGATTACCAGTGACAG	DS7
GGATTACCATGGATGG	VU
GGATTACGTCCCTTGT	DS6
GGATTACGTCGCATCG	DS7
GGATTACGTCTAGCCG	DS7
GGATTACGTCTCTTAT	DS6
GGATTACGTGCAACTT	DS3
GGATTACGTGCAGACA	VU
GGATTACGTTCTGTTT	DS8
GGATTACTCACAAACC	DS9
GGATTACTCAGCTCGG	DS9
GGATTACTCCATGAGT	DS6
GGATTACTCTTGCCGT	VU
GGCAATTAGATGCCAG	VU
GGCAATTAGGCAGTCA	VU
GGCAATTCACAACGTT	DS6
GGCAATTCACCCATTC	DS6
GGCAATTGTGAGTATA	DS8
GGCAATTGTGTCAATC	DS3
GGCAATTGTTAAGATG	DS7
GGCAATTTCAGCGACC	DS6
GGCAATTTCCAGAAGG	DS6
GGCAATTTCCTACAGA	DS9
GGCAATTTCTCGTATT	DS6
GGCCGATAGATGGCGT	DS7
GGCCGATAGTCCAGGA	VU
GGCCGATAGTTTCCTT	VU
GGCCGATCAAAGGCGT	DS9
GGCCGATCAAGAAGAG	DS7
GGCCGATCAAGTAGTA	DS6
GGCCGATCAGCTATTG	DS6
GGCCGATGTACCGCTG	DS6
GGCCGATGTACGCTGC	DS6
GGCCGATGTCCTCTTG	DS6
GGCCGATGTCTAGTGT	DS3
GGCCGATGTGCCTGTG	DS7
GGCCGATTCACTCTTA	DS6
GGCCGATTCATTGCCC	DS7
GGCCGATTCCTACAGA	DS6
GGCCGATTCCTTCAAT	DS8
GGCGACTAGAGCCTAG	DS6
GGCGACTCACACCGAC	DS8
GGCGACTCAGGAATCG	DS8
GGCGACTCATTGGTAC	DS6
GGCGACTGTACAGTGG	DS8
GGCGACTGTAGGCATG	VU
GGCGACTGTTCGGCAC	DS6
GGCGACTTCAATACCG	DS3
GGCGACTTCCACTCCA	DS7
GGCGACTTCGGCTACG	VU
GGCGACTTCGTCGTTC	DS6
GGCGTGTAGACACTAA	DS3
GGCGTGTAGAGGACGG	DS7
GGCGTGTAGGCTAGCA	DS3
GGCGTGTAGTGTGGCA	DS7
GGCGTGTAGTTGTAGA	DS8
GGCGTGTCACAGCGTC	DS3
GGCGTGTCAGCATGAG	DS3
GGCGTGTCAGTGACAG	DS6
GGCGTGTTCTCTTATG	DS7
GGCTCGAAGGGTCGAT	DS9
GGCTCGACAAGGGTCA	DS6
GGCTCGACACACTGCG	DS8
GGCTCGACACGGTTTA	DS7
GGCTCGACATCACAAC	DS6
GGCTCGAGTTAGGGTG	DS7
GGCTCGATCGTCTGAA	DS3
GGCTGGTAGCAGACTG	DS7
GGCTGGTAGCCGATTT	DS3
GGCTGGTAGGATCGCA	DS9
GGCTGGTAGTTGCAGG	DS9
GGCTGGTCAAATACAG	VU
GGCTGGTCAGGACGTA	DS3
GGCTGGTCATGACGGA	DS9
GGCTGGTGTACTCTCC	DS6
GGCTGGTGTGGTCTCG	DS7
GGCTGGTGTTCAGACT	DS6
GGCTGGTGTTCCCTTG	DS7
GGCTGGTTCCCTCAGT	VU
GGCTGGTTCGTGGGAA	DS9
GGGAATGAGAGGTTGC	DS3
GGGAATGAGCGTCTAT	DS7
GGGAATGAGGCTCTTA	DS6
GGGAATGAGTTTGCGT	VU
GGGAATGCAAATACAG	DS3
GGGAATGCACGAAGCA	DS9
GGGAATGCAGATAATG	DS6
GGGAATGGTAACGTTC	DS3
GGGAATGGTAGGACAC	VU
GGGAATGGTATATCCG	DS8
GGGAATGTCAGTCAGT	DS7
GGGAATGTCATAACCG	DS3
GGGACCTAGACAAAGG	DS8
GGGACCTAGAGGACGG	DS8
GGGACCTAGCAATATG	DS3
GGGACCTAGGGTCGAT	DS6
GGGACCTCAAGCCATT	DS7
GGGACCTGTCTACCTC	DS9
GGGACCTGTGTCTGAT	DS6
GGGACCTGTTAAGTAG	VU
GGGACCTTCCAAACAC	DS9
GGGACCTTCGCATGGC	DS8
GGGACCTTCGCTTGTC	DS6
GGGACCTTCGTGGGAA	DS3
GGGACCTTCTAACCGA	DS7
GGGAGATAGAGACTAT	DS6
GGGAGATAGAGCAATT	DS9
GGGAGATAGTTAGCGG	VU
GGGAGATCAGACAAAT	DS7
GGGAGATCAGATTGCT	DS6
GGGAGATGTAGATTAG	DS6
GGGAGATGTATTCGTG	DS3
GGGAGATGTCAGGACA	DS8
GGGAGATGTCGAGTTT	VU
GGGAGATGTGTGACCC	VU
GGGAGATTCTGGTATG	DS8
GGGAGATTCTTAGAGC	DS7
GGGATGAAGAACAATC	DS8
GGGATGAAGATGCCTT	DS8
GGGATGAAGCAGGTCA	DS3
GGGATGAAGTAGGTGC	DS6
GGGATGAAGTCGTACT	DS8
GGGATGAAGTGGTAGC	DS6
GGGATGAAGTTCGCGC	DS7
GGGATGACAATGGTCT	VU
GGGATGACACAGAGGT	DS7
GGGATGACATATACGC	DS6
GGGATGAGTAAATACG	DS9
GGGATGAGTACACCGC	DS9
GGGATGAGTCGGCATC	DS9
GGGATGATCAGCCTAA	VU
GGGATGATCATGTGGT	VU
GGGATGATCCACTCCA	VU
GGGATGATCCTTTCGG	DS7
GGGATGATCGCTTGTC	DS7
GGGCACTAGCTCCTTC	DS8
GGGCACTAGGATCGCA	DS9
GGGCACTAGGCTACGA	DS3
GGGCACTCAAGCCCAC	DS6
GGGCACTCACGTTGGC	VU
GGGCACTCATAACCTG	DS7
GGGCACTCATCCCATC	DS8
GGGCACTCATCGGGTC	DS7
GGGCACTCATGCAACT	DS6
GGGCACTGTAAGGATT	DS9
GGGCACTGTCGCCATG	DS6
GGGCACTTCCCAGGTG	DS6
GGGCACTTCGCCTGAG	DS9
GGGCACTTCTGCCAGG	DS6
GGGCATCAGCAATCTC	DS6
GGGCATCAGCGGATCA	VU
GGGCATCAGGCCCTCA	DS7
GGGCATCAGTCGATAA	DS8
GGGCATCCACGGCGTT	DS7
GGGCATCCAGGACCCT	DS8
GGGCATCCAGTACACT	DS3
GGGCATCGTAGCGTCC	DS8
GGGCATCGTCTGGTCG	DS6
GGGCATCGTGAGCGAT	DS6
GGGCATCGTGCGATAG	DS7
GGGCATCGTGGTTTCA	DS6
GGGCATCTCCAGAGGA	DS8
GGGTCTGAGAAGATTC	DS6
GGGTCTGAGCAGCCTC	DS3
GGGTCTGAGGAATTAC	DS3
GGGTCTGCAGCGTTCG	VU
GGGTCTGCATAGTAAG	DS3
GGGTCTGCATGTTGAC	DS6
GGGTCTGGTCGGGTCT	DS3
GGGTCTGGTGTGAAAT	DS7
GGGTCTGGTGTGGCTC	DS9
GGGTCTGGTTAAGACA	DS8
GGGTCTGTCTCTGCTG	DS3
GGGTTGCAGAATTCCC	VU
GGGTTGCAGACACTAA	DS7
GGGTTGCAGCTGCCCA	DS9
GGGTTGCAGTAGGTGC	DS7
GGGTTGCAGTTCGCGC	DS6
GGGTTGCCACGTTGGC	VU
GGGTTGCCACTGTTAG	DS6
GGGTTGCCATGGTCAT	DS8
GGGTTGCGTCTAGCGC	DS8
GGGTTGCGTGAGGGTT	DS7
GGGTTGCTCACGGTTA	DS7
GGGTTGCTCAGGATCT	DS7
GGTATTGAGATCCCGC	DS7
GGTATTGAGTACATGA	DS6
GGTATTGAGTGAATTG	VU
GGTATTGCACAAGCCC	VU
GGTATTGCACATCTTT	DS3
GGTATTGCATCCGGGT	DS8
GGTATTGCATTCCTCG	DS8
GGTATTGGTACAGTGG	DS6
GGTATTGTCCCTCTTT	DS6
GGTGAAGAGAGGACGG	DS9
GGTGAAGAGATATGCA	DS7
GGTGAAGAGATCGGGT	DS7
GGTGAAGAGTACGTAA	DS8
GGTGAAGCAAGTTGTC	DS6
GGTGAAGGTAAGAGAG	DS6
GGTGAAGGTAAGGGAA	DS7
GGTGAAGGTAGCGATG	DS6
GGTGAAGTCTCGGACG	DS8
GGTGCGTAGCGATAGC	DS6
GGTGCGTAGGGTTCCC	DS6
GGTGCGTCACGGCGTT	DS8
GGTGCGTCAGCATACT	DS9
GGTGCGTCATGCCCGA	DS6
GGTGCGTCATTCCTCG	DS6
GGTGCGTGTCAAGCGA	DS7
GGTGCGTTCAACGGCC	DS6
GGTGCGTTCCAGAAGG	DS8
GGTGCGTTCCAGGGCT	DS7
GGTGCGTTCCGCTGTT	DS6
GGTGTTAAGCCAGGAT	VU
GGTGTTAAGTTATCGC	DS9
GGTGTTACACCATCCT	DS6
GGTGTTACACTAAGTC	DS6
GGTGTTACATTGAGCT	VU
GGTGTTAGTAACGACG	DS7
GGTGTTAGTCCCGACA	DS7
GGTGTTAGTCTTTCAT	DS9
GGTGTTAGTGATGTCT	DS7
GGTGTTATCAACACTG	DS7
GGTGTTATCAGAGCTT	DS6
GGTGTTATCTTTCCTC	DS7
GTAACGTAGACACTAA	DS9
GTAACGTAGCCCAGCT	DS8
GTAACGTAGGACACCA	DS7
GTAACGTAGGATATAC	DS3
GTAACGTAGTGTTTGC	DS3
GTAACGTCATGCAACT	DS3
GTAACGTCATGGTCTA	DS9
GTAACGTGTCATATGC	DS7
GTAACGTGTCTAGAGG	DS9
GTAACGTGTGTGCGTC	DS3
GTAACGTGTTGGTTTG	DS7
GTAACGTTCACGACTA	DS7
GTAACGTTCAGTTTGG	DS8
GTAACGTTCGCTGATA	DS8
GTAACGTTCTTCAACT	DS3
GTAACTGAGGACACCA	DS9
GTAACTGAGGAGTTTA	DS6
GTAACTGAGGCAAAGA	DS7
GTAACTGCAATGGATA	DS7
GTAACTGCAGCTTAAC	DS6
GTAACTGCATTGGGCC	DS3
GTAACTGGTTCATGGT	DS8
GTAACTGTCAATAAGG	DS3
GTAACTGTCTGGCGTG	DS8
GTAACTGTCTTAGAGC	DS6
GTAACTGTCTTGTACT	DS6
GTACGTAAGACTGTAA	DS7
GTACGTAAGATGTGTA	DS6
GTACGTAAGGACAGCT	DS8
GTACGTAAGTACGCCC	DS6
GTACGTAAGTCCGTAT	DS8
GTACGTACAGGCTCAC	DS8
GTACGTACATGTTCCC	DS7
GTACGTAGTATCGCAT	DS7
GTACGTAGTATGAATG	DS7
GTACGTAGTGGTACAG	DS7
GTACGTATCCTCAATT	VU
GTACGTATCGGCCGAT	VU
GTACGTATCGTCACGG	DS8
GTACTCCAGAAGATTC	DS3
GTACTCCAGATTACCC	DS7
GTACTCCAGCCCAGCT	DS3
GTACTCCAGTATTGGA	DS6
GTACTCCAGTCGATAA	DS8
GTACTCCCAACAACCT	DS9
GTACTCCCAGGCTCAC	DS8
GTACTCCCATCGGTTA	DS9
GTACTCCGTGCCTGTG	DS7
GTACTCCTCTTGTCAT	VU
GTACTTTAGCTGAAAT	DS8
GTACTTTAGCTGCAAG	DS6
GTACTTTCACCATCCT	DS6
GTACTTTCACGTTGGC	DS9
GTACTTTCACTCGACG	DS7
GTACTTTCAGCGATCC	DS9
GTACTTTCAGGCTCAC	DS6
GTACTTTCAGTCGATT	DS6
GTACTTTCATGGTCAT	DS9
GTACTTTGTCACCCAG	DS6
GTACTTTGTCTAGGTT	DS9
GTACTTTGTTACGGAG	DS8
GTACTTTGTTCGTCTC	DS8
GTACTTTGTTGCGTTA	DS6
GTACTTTTCAGAGCTT	DS8
GTACTTTTCCCTAACC	VU
GTACTTTTCGCGCCAA	DS8
GTACTTTTCGCGTTTC	DS3
GTAGGCCAGCGTGAGT	DS6
GTAGGCCAGGAGCGAG	DS7
GTAGGCCAGGCAAAGA	DS3
GTAGGCCAGGTTCCTA	DS3
GTAGGCCAGTCGTACT	DS7
GTAGGCCAGTGTCCAT	DS6
GTAGGCCCAGACTCGC	DS6
GTAGGCCCATCCTAGA	DS6
GTAGGCCGTAGGAGTC	VU
GTAGGCCGTCTGATCA	DS6
GTAGGCCGTTCCACTC	DS6
GTAGGCCTCCTCAACC	DS7
GTAGTCAAGATGCCTT	DS9
GTAGTCAAGCGCCTCA	DS9
GTAGTCAAGTGTACGG	DS6
GTAGTCACAAGCGCTC	DS7
GTAGTCACATAGACTC	DS6
GTAGTCAGTGCTTCTC	DS3
GTAGTCAGTGTGAAAT	DS6
GTAGTCAGTTCAGGCC	VU
GTAGTCAGTTCGGGCT	DS3
GTAGTCATCAAACGGG	DS8
GTAGTCATCAGCTCTC	DS7
GTAGTCATCCAGGGCT	DS7
GTAGTCATCCGCGTTT	VU
GTAGTCATCGCAAGCC	DS3
GTAGTCATCGTTACGA	DS9
GTAGTCATCTCCCTGA	DS6
GTAGTCATCTCCGGTT	DS9
GTATCTTAGGGCTTCC	VU
GTATCTTCAATCTGCA	DS6
GTATCTTCACTTAAGC	DS6
GTATCTTCATGCATGT	DS6
GTATCTTGTGTCTGAT	DS9
GTATCTTTCATAACCG	DS7
GTATCTTTCTCTTATG	DS6
GTATTCTAGATGGCGT	DS6
GTATTCTAGCTGATAA	DS3
GTATTCTCACGGCTAC	DS9
GTATTCTCAGTTTACG	DS8
GTATTCTCATCTATGG	DS7
GTATTCTGTAGCAAAT	VU
GTATTCTGTCGAACAG	DS8
GTATTCTGTTATCCGA	DS6
GTATTCTTCACCACCT	DS9
GTATTCTTCTCTTGAT	DS7
GTATTCTTCTGGTATG	DS6
GTCAAGTAGACCCACC	DS8
GTCAAGTAGGTGTGGT	VU
GTCAAGTAGTCTTGCA	VU
GTCAAGTCATTAACCG	DS6
GTCAAGTGTACGAAAT	DS3
GTCAAGTGTCAATACC	DS6
GTCAAGTGTCTCCATC	DS8
GTCAAGTGTGGCTCCA	VU
GTCAAGTGTTACAGAA	VU
GTCAAGTGTTGGTGGA	DS7
GTCAAGTTCAGGCCCA	DS8
GTCAAGTTCCGCTGTT	VU
GTCAAGTTCCTAGTGA	VU
GTCACAAAGAGTAAGG	DS8
GTCACAAAGCGATCCC	VU
GTCACAAAGGGCACTA	DS8
GTCACAAAGTAGATGT	DS9
GTCACAACAGATCCAT	VU
GTCACAACAGCGTTCG	DS3
GTCACAAGTTACGACT	DS9
GTCACAATCGAACTGT	DS9
GTCACAATCTACCTGC	DS3
GTCACAATCTGATTCT	DS8
GTCACAATCTGCCCTA	VU
GTCACAATCTGTCTAT	DS9
GTCACGGAGAGTAAGG	DS8
GTCACGGCAACTGCGC	DS8
GTCACGGCAGATAATG	VU
GTCACGGCATCCCACT	DS9
GTCACGGCATGCAACT	DS8
GTCACGGCATGTCTCC	DS9
GTCACGGGTGTGCGTC	DS7
GTCACGGGTTGAGGTG	DS6
GTCACGGGTTGCCTCT	DS6
GTCACGGTCGGAGGTA	DS8
GTCATTTAGCCAGTAG	DS6
GTCATTTAGTTGTCGT	VU
GTCATTTCAAGGACAC	DS6
GTCATTTCAAGTCATC	DS6
GTCATTTCATGCGCAC	DS6
GTCATTTGTAAGAGGA	DS3
GTCATTTGTCCCTTGT	DS6
GTCATTTGTGCGAAAC	DS8
GTCATTTGTTATGTGC	DS7
GTCATTTTCTCTGAGA	VU
GTCATTTTCTTATCTG	DS7
GTCATTTTCTTCCTTC	DS7
GTCCTCACACTGTCGG	DS6
GTCCTCACATGCAACT	VU
GTCCTCAGTCTTGATG	DS8
GTCCTCAGTTATCCGA	DS7
GTCCTCATCGGCTTGG	DS6
GTCCTCATCTAGCACA	DS7
GTCGGGTAGAATGTTG	DS9
GTCGGGTAGACAGGCT	DS3
GTCGGGTAGTAGCGGT	DS3
GTCGGGTAGTGAATTG	DS7
GTCGGGTAGTTTAGGA	DS8
GTCGGGTCACAGACTT	DS9
GTCGGGTCACGCCAGT	DS8
GTCGGGTCAGCTGTGC	DS7
GTCGGGTGTGTTTGGT	DS8
GTCGGGTGTTGGTTTG	DS9
GTCGGGTTCAGCGATT	DS6
GTCGGGTTCAGGCGAA	VU
GTCGGGTTCATCACCC	DS9
GTCGGGTTCCCATTTA	VU
GTCGGGTTCCCTAACC	DS6
GTCGGGTTCGGCGCTA	DS3
GTCGGGTTCTCGCATC	DS6
GTCGTAAAGGCTCATT	VU
GTCGTAAAGGTGATAT	DS6
GTCGTAAAGTTTGCGT	VU
GTCGTAACAGCGTCCA	DS8
GTCGTAAGTCTAGTGT	DS7
GTCGTAAGTGCCTGCA	DS3
GTCGTAAGTGTAACGG	DS6
GTCGTAAGTTCCGTCT	DS3
GTCGTAAGTTGATTGC	DS6
GTCGTAATCAACACCA	DS8
GTCGTAATCCCAGGTG	DS7
GTCGTAATCTATCCCG	DS8
GTCTCGTAGAAGGGTA	DS6
GTCTCGTAGCTCCTTC	DS6
GTCTCGTAGGAACTGC	DS7
GTCTCGTAGGAATTAC	DS9
GTCTCGTCAGCTGTTA	DS9
GTCTCGTCAGTCCTTC	DS9
GTCTCGTGTAATAGCA	VU
GTCTCGTGTACAGACG	VU
GTCTTCGAGTACATGA	DS6
GTCTTCGAGTGTTAGA	DS9
GTCTTCGCAGCTGCAC	DS7
GTCTTCGCATCCTAGA	DS7
GTCTTCGCATGGTCTA	DS6
GTCTTCGCATTGGCGC	DS8
GTCTTCGGTGGTACAG	DS8
GTCTTCGTCAAACCGT	DS6
GTCTTCGTCATTATCC	DS8
GTCTTCGTCCGCATCT	DS8
GTCTTCGTCGAATGCT	DS3
GTCTTCGTCGGCGCTA	VU
GTCTTCGTCTGTCCGT	DS8
GTGAAGGAGCCAGAAC	VU
GTGAAGGAGCTCAACT	DS6
GTGAAGGCATCCAACA	DS6
GTGAAGGGTCACCCAG	DS9
GTGAAGGGTCCAGTAT	DS9
GTGAAGGGTCGTCTTC	DS3
GTGAAGGGTGATGTCT	DS7
GTGAAGGGTGCATCTA	DS3
GTGAAGGGTTACAGAA	DS9
GTGAAGGTCCAAACAC	DS7
GTGAAGGTCCAAACTG	DS6
GTGAAGGTCCAGAGGA	DS9
GTGAAGGTCCCAGGTG	DS9
GTGCAGCAGAAACGCC	DS6
GTGCAGCAGATAGCAT	DS9
GTGCAGCAGCTGTTCA	DS3
GTGCAGCAGTACGACG	DS8
GTGCAGCCAAAGTCAA	DS6
GTGCAGCCAAGCGCTC	DS8
GTGCAGCGTCCAAGTT	DS9
GTGCAGCGTTCCTCCA	VU
GTGCAGCGTTCTGTTT	DS6
GTGCAGCTCACGCATA	DS8
GTGCAGCTCACTCTTA	DS8
GTGCATAAGAGGTTGC	DS6
GTGCATAAGGCTCATT	DS6
GTGCATACAGAGTGTG	DS9
GTGCATACAGCTGGCT	DS6
GTGCATACAGGGTACA	DS8
GTGCATACATGTCCTC	DS8
GTGCATAGTAAGCACG	DS8
GTGCATAGTAGGGACT	DS8
GTGCATAGTTCCAACA	DS6
GTGCATATCCTTAATC	DS7
GTGCGGTAGAACAATC	DS9
GTGCGGTAGATGTAAC	DS8
GTGCGGTAGCCACTAT	DS7
GTGCGGTAGTATCGAA	DS9
GTGCGGTCAGAGCCAA	VU
GTGCGGTCAGCTTAAC	DS6
GTGCGGTGTGACTACT	VU
GTGCGGTTCACGCATA	DS8
GTGCGGTTCGTGGTCG	DS8
GTGCGGTTCTATCCTA	DS3
GTGCGGTTCTCCGGTT	DS7
GTGCTTCAGAGTCTGG	DS8
GTGCTTCCAAGCCGTC	DS6
GTGCTTCCAAGCTGAG	DS6
GTGCTTCCAATGGATA	VU
GTGCTTCGTATATGAG	DS7
GTGCTTCGTCCTCCAT	DS8
GTGCTTCGTTGGGACA	DS9
GTGCTTCGTTTCCACC	DS9
GTGCTTCTCACAAACC	DS9
GTGCTTCTCAGCTTAG	DS3
GTGCTTCTCGCGTAGC	DS8
GTGCTTCTCGCTTGTC	DS8
GTGCTTCTCTGTACGA	DS6
GTGGGTCAGATGTTAG	DS9
GTGGGTCAGCTGATAA	DS6
GTGGGTCCACCAGTTA	DS3
GTGGGTCGTAAGTTCC	DS3
GTGGGTCGTCTCTTTA	DS3
GTGGGTCGTGTGAATA	DS8
GTGGGTCTCACTTCAT	DS3
GTGGGTCTCCGTAGGC	DS6
GTGGGTCTCGCGCCAA	DS7
GTGGGTCTCTCAAGTG	DS3
GTGTGCGAGAAGCCCA	DS9
GTGTGCGCAGATGAGC	DS6
GTGTGCGGTCTCATCC	DS7
GTGTGCGGTTATCCGA	DS6
GTGTGCGTCAGGCAAG	DS7
GTGTGCGTCGGTCTAA	DS7
GTGTGCGTCGTAGGAG	DS7
GTGTGCGTCTGCAAGT	DS8
GTGTGCGTCTGGTGTA	DS7
GTGTTAGAGATCGATA	DS3
GTGTTAGAGGACACCA	DS8
GTGTTAGCACGGACAA	DS7
GTGTTAGCAGATGGCA	DS9
GTGTTAGGTAAATACG	DS3
GTGTTAGGTCTTCTCG	DS8
GTGTTAGGTGAGGGAG	DS6
GTGTTAGGTTAGATGA	DS8
GTGTTAGTCAAGCCTA	DS6
GTGTTAGTCATGTCTT	DS6
GTGTTAGTCTTAGCCC	DS6
GTTAAGCAGAAACCGC	VU
GTTAAGCAGATCGGGT	DS6
GTTAAGCAGATGGCGT	VU
GTTAAGCAGTGTCCAT	DS6
GTTAAGCAGTTTGCGT	DS9
GTTAAGCCAAAGGCGT	DS3
GTTAAGCCAATCCAAC	DS8
GTTAAGCCAGCTGCTG	DS3
GTTAAGCCATCTCCCA	DS6
GTTAAGCCATTGGTAC	DS9
GTTAAGCGTAAACACA	DS9
GTTAAGCGTCGCTTTC	DS6
GTTAAGCGTTAGGGTG	DS7
GTTAAGCGTTCAACCA	DS7
GTTAAGCTCAGTTCGA	DS6
GTTAAGCTCATATCGG	DS6
GTTAAGCTCATTGCCC	DS8
GTTAAGCTCCACGTGG	DS7
GTTAAGCTCCAGTATG	DS7
GTTAAGCTCGGGAGTA	DS9
GTTAAGCTCGTGGTCG	DS6
GTTAAGCTCTCCTATA	DS6
GTTACAGAGAAGATTC	DS6
GTTACAGAGAGTAAGG	DS9
GTTACAGAGCCTTGAT	DS3
GTTACAGAGCTGATAA	DS7
GTTACAGAGGAATCGC	DS7
GTTACAGGTGCTGTAT	DS6
GTTACAGGTTCGTCTC	DS6
GTTACAGTCAGCTCGG	DS7
GTTACAGTCGAATGCT	DS8
GTTCATTAGGTGCTAG	DS3
GTTCATTAGTGGTAAT	VU
GTTCATTGTACCATCA	DS8
GTTCATTGTGGCCCTA	DS6
GTTCATTGTTATCACG	DS8
GTTCATTTCAATCACG	DS6
GTTCGGGAGATGCCTT	DS6
GTTCGGGAGCCACGTC	DS6
GTTCGGGAGCTCCCAG	DS3
GTTCGGGAGTAGGCCA	DS8
GTTCGGGCACAAGACG	DS8
GTTCGGGCAGCTATTG	DS9
GTTCGGGCAGTATGCT	DS8
GTTCGGGGTACTCGCG	DS7
GTTCGGGGTCAGAATA	DS6
GTTCGGGGTGGACGAT	DS9
GTTCGGGTCTCCAGGG	DS8
GTTCTCGAGGACAGAA	DS7
GTTCTCGAGGACATTA	DS7
GTTCTCGCAAGGTTCT	DS6
GTTCTCGCACATCTTT	DS8
GTTCTCGGTACACCGC	DS8
GTTCTCGGTCCGTCAG	DS3
GTTCTCGGTCGCATAT	DS8
GTTCTCGTCAATCTCT	DS7
GTTCTCGTCGTAGGTT	VU
GTTTCTAAGCGACGTA	DS6
GTTTCTAAGCTAGGCA	DS9
GTTTCTAAGTACGATA	VU
GTTTCTAAGTCATGCT	DS7
GTTTCTAAGTCTCCTC	VU
GTTTCTACAAGACGTG	DS6
GTTTCTACACCAACCG	VU
GTTTCTACACTGAAGG	DS3
GTTTCTAGTACACCGC	VU
GTTTCTAGTGTCGCTG	VU
GTTTCTATCGACAGCC	DS9
GTTTCTATCTCACATT	DS6
TAAACCGAGAGTAATC	DS7
TAAACCGAGCGCCTTG	DS9
TAAACCGCAAACTGCT	DS6
TAAACCGCAAGCCATT	DS6
TAAACCGGTACCGCTG	DS8
TAAACCGGTCCTAGCG	DS6
TAAACCGGTCCTCTTG	DS9
TAAACCGGTGACCAAG	DS7
TAAACCGGTGCATCTA	DS7
TAAACCGGTGTGACGA	DS6
TAAACCGGTTCACCTC	DS8
TAAACCGTCACGATGT	DS9
TAAACCGTCACTTATC	DS6
TAAACCGTCAGAGGTG	DS8
TAAACCGTCAGCACAT	DS9
TAAACCGTCCTACAGA	DS9
TAAACCGTCTCAAGTG	DS7
TAAACCGTCTCTAAGG	VU
TAAGAGAAGTGGGCTA	DS3
TAAGAGACACCTATCC	DS6
TAAGAGACACTAAGTC	DS7
TAAGAGACATCCGGGT	DS6
TAAGAGAGTAGGCATG	DS7
TAAGAGAGTCATTAGC	DS3
TAAGAGAGTCGGGTCT	DS9
TAAGAGAGTCTTCGTC	DS8
TAAGAGAGTGTGACCC	DS7
TAAGAGATCGCATGAT	DS3
TAAGAGATCTTCAACT	DS9
TAAGAGATCTTTCCTC	DS7
TAAGCGTCACAGCCCA	DS7
TAAGCGTCATAGACTC	DS8
TAAGCGTGTCGCATCG	VU
TAAGCGTGTCTGCAAT	DS7
TAAGCGTGTGAGGGAG	DS9
TAAGCGTGTGCATCTA	VU
TAAGCGTGTTGGGACA	DS9
TAAGCGTTCGTGGGAA	DS6
TAAGCGTTCTACTCAT	DS7
TAAGTGCAGCGCCTCA	VU
TAAGTGCAGGGATACC	DS9
TAAGTGCAGGGTTCCC	VU
TAAGTGCAGTGGAGAA	VU
TAAGTGCAGTGGTAAT	DS6
TAAGTGCCACCAGGTC	VU
TAAGTGCGTAATCGTC	DS7
TAAGTGCGTAGCGTCC	VU
TAAGTGCGTCAAACTC	DS8
TAAGTGCGTCTAACGT	DS3
TAAGTGCGTTCATGGT	DS7
TAAGTGCTCACAATGC	DS8
TAAGTGCTCTCGTTTA	DS9
TACACGAAGAGCTGGT	DS6
TACACGAAGCAGCCTC	VU
TACACGAAGGCTAGCA	DS7
TACACGAAGTACATGA	VU
TACACGACAGCCTGTG	DS3
TACACGACAGTCAGAG	VU
TACACGAGTATAGGTA	DS8
TACACGAGTCTCTTTA	DS3
TACACGAGTGGTCTCG	DS9
TACACGAGTGTTGAGG	DS9
TACACGAGTTACGGAG	DS6
TACACGAGTTCCATGA	DS3
TACACGATCAATCTCT	DS3
TACACGATCACCTTAT	DS8
TACACGATCGATCCCT	DS6
TACACGATCTAGAGTC	VU
TACACGATCTGGTTCC	DS6
TACAGTGAGATCCCGC	DS9
TACAGTGCACATTAGC	DS7
TACAGTGCACGGACAA	DS6
TACAGTGGTACGACCC	DS6
TACAGTGGTCGGCACT	DS3
TACAGTGGTGGTACAG	DS8
TACAGTGGTTGTGGCC	DS9
TACAGTGTCAACACAC	DS6
TACAGTGTCCTAAGTG	DS6
TACAGTGTCTGGTATG	DS9
TACAGTGTCTTCGGTC	DS6
TACCTATAGCCAGGAT	DS6
TACCTATAGCGCTCCA	DS3
TACCTATCAAACGTGG	DS6
TACCTATCAAGTAATG	DS8
TACCTATCAAGTTCTG	DS8
TACCTATCACATAACC	DS6
TACCTATCACGGCCAT	DS9
TACCTATCACTGTGTA	DS8
TACCTATCAGGATTGG	DS9
TACCTATGTAAATGTG	DS8
TACCTATTCCTTGGTC	DS8
TACCTATTCGAATCCA	DS3
TACCTATTCTATCCTA	DS6
TACCTTAAGACACGAC	DS8
TACCTTAAGCAAATCA	DS9
TACCTTAAGCGCCTCA	DS7
TACCTTAAGGCGACAT	DS3
TACCTTAAGTGACTCT	DS3
TACCTTACAATTCCTT	DS8
TACCTTACACCGATAT	DS7
TACCTTACATGGATGG	DS6
TACCTTAGTAGGGTAC	VU
TACCTTAGTGCCTGTG	DS6
TACCTTAGTGGCAAAC	DS6
TACCTTATCATTATCC	DS7
TACCTTATCCTAGGGC	DS3
TACCTTATCCTGCCAT	DS6
TACCTTATCGCTTAGA	DS8
TACCTTATCTTACCTA	VU
TACGGATAGCCACTAT	DS9
TACGGATAGTGAATTG	DS3
TACGGATCATGCCCGA	DS3
TACGGATGTCCAACTA	DS6
TACGGATGTCGCTTCT	DS9
TACGGATGTCTCACCT	VU
TACGGATGTGTAAGTA	DS3
TACGGATGTTCCACGG	DS8
TACGGATGTTGGACCC	DS3
TACGGATGTTTCGCTC	DS6
TACGGATTCAATACCG	DS6
TACGGATTCCAAACTG	DS7
TACGGGCAGCAATCTC	DS7
TACGGGCAGCTAGTCT	DS6
TACGGGCAGTGAAGTT	DS9
TACGGGCAGTGTTAGA	DS6
TACGGGCAGTTACGGG	DS7
TACGGGCCAGGTGCCT	DS6
TACGGGCCATCCTTGC	DS7
TACGGGCCATGATCCA	DS9
TACGGGCGTTACAGAA	DS3
TACGGGCGTTACTGAC	DS6
TACGGGCTCCTAGGGC	DS9
TACGGGCTCGCCTGTT	DS7
TACGGGCTCGCGCCAA	VU
TACGGGCTCTGCCAGG	DS3
TACGGGCTCTGCCCTA	DS6
TACGGTAAGGATGTAT	DS6
TACGGTAAGTTAACGA	DS9
TACGGTACACAGTCGC	DS7
TACGGTAGTAGTAGTA	DS8
TACGGTAGTGCTAGCC	DS9
TACGGTAGTGGTCCGT	DS8
TACGGTATCCGAACGC	DS6
TACGGTATCCTGCCAT	DS6
TACGGTATCGTACCGG	DS7
TACTCATAGCCCGAAA	DS3
TACTCATAGCGATATA	DS9
TACTCATAGTGTACTC	DS6
TACTCATAGTTTCCTT	VU
TACTCATAGTTTGCGT	DS3
TACTCATCAACGCACC	DS8
TACTCATCACGACTCG	DS3
TACTCATCAGGGTTAG	DS3
TACTCATCATGCTGGC	DS7
TACTCATGTGTGACCC	VU
TACTCATGTGTGCGTC	DS3
TACTCATGTTATGTGC	DS9
TACTCATTCAACGCTA	DS8
TACTCATTCAGCTTAG	DS9
TACTCATTCATGTAGC	DS9
TACTCATTCGCCGTGA	DS7
TACTCATTCTAGAGTC	DS8
TACTCGCAGACCTTTG	DS9
TACTCGCAGCCAGAAC	DS6
TACTCGCAGGGAAACA	DS3
TACTCGCAGTGTTGAA	DS3
TACTCGCAGTTCGCGC	DS3
TACTCGCCACTTCTGC	DS6
TACTCGCCAGAAGCAC	DS8
TACTCGCCAGACAAAT	DS8
TACTCGCGTGATGCCC	DS6
TACTCGCTCAGTGCAT	DS8
TACTCGCTCGGAGGTA	VU
TACTCGCTCGTATCAG	DS6
TACTCGCTCTCCGGTT	VU
TACTTACAGAATGTGT	DS3
TACTTACAGTGTGGCA	DS3
TACTTACAGTTATCGC	DS8
TACTTACCAGACTCGC	DS8
TACTTACCAGCTGTGC	DS3
TACTTACCATCTATGG	DS7
TACTTACCATCTCGCT	DS3
TACTTACGTGCAGACA	DS8
TACTTACGTTCAGGCC	DS6
TACTTACTCCACGAAT	DS8
TACTTACTCGCATGGC	DS3
TACTTACTCGTTGCCT	VU
TACTTGTAGAGTGACC	DS3
TACTTGTAGCGACGTA	DS8
TACTTGTAGCTCCTCT	VU
TACTTGTAGGATTCGG	DS6
TACTTGTAGGGCATGT	DS6
TACTTGTCAAATACAG	DS6
TACTTGTCAGTATCTG	DS6
TACTTGTGTAGCGTCC	DS7
TACTTGTGTATGCTTG	DS8
TACTTGTGTGAAATCA	DS8
TACTTGTTCATTTGGG	VU
TACTTGTTCGTGGGAA	DS8
TACTTGTTCTTGCCGT	DS6
TAGACCAAGCCTTGAT	DS7
TAGACCAAGCGAGAAA	DS8
TAGACCACAGAGTGTG	VU
TAGACCAGTCGCCATG	DS8
TAGACCAGTCGGCACT	DS8
TAGACCAGTCTCCACT	DS8
TAGACCATCAACGAAA	VU
TAGACCATCACAATGC	DS6
TAGACCATCGGCTTGG	DS8
TAGAGCTAGAAACCGC	DS6
TAGAGCTAGCATCATC	VU
TAGAGCTAGGCATGGT	DS8
TAGAGCTAGGCTATCT	DS8
TAGAGCTAGTCCATAC	VU
TAGAGCTAGTGTTAGA	DS8
TAGAGCTCACATCCAA	DS7
TAGAGCTGTCGACTGC	VU
TAGAGCTGTTAAAGTG	VU
TAGAGCTTCACTATTC	DS7
TAGAGCTTCTACTATC	DS7
TAGAGCTTCTCTAGGA	DS9
TAGAGCTTCTGGGCCA	DS6
TAGCCGGCAATAGCGG	DS8
TAGCCGGCACACAGAG	DS3
TAGCCGGCAGTCAGCC	DS8
TAGCCGGGTCTAGTGT	DS8
TAGCCGGGTCTCACCT	DS3
TAGCCGGTCATCACCC	DS7
TAGCCGGTCGCAAACT	DS6
TAGGCATAGCGACGTA	DS3
TAGGCATAGTGACTCT	DS7
TAGGCATCAATCAGAA	DS8
TAGGCATCAGACGCTC	DS6
TAGGCATGTATAAACG	DS6
TAGGCATGTGCTCTTC	DS6
TAGGCATGTGGTTTCA	DS6
TAGGCATGTTACGTCA	DS3
TAGGCATTCACCGTAA	DS6
TAGGCATTCAGTTGAC	DS8
TAGGCATTCCCTAATT	DS3
TAGGCATTCGATCCCT	DS7
TAGGCATTCTCAACTT	DS8
TAGTGGTAGCCAGTTT	DS7
TAGTGGTAGGAGCGTT	DS9
TAGTGGTAGTCTCGGC	DS6
TAGTGGTCAAGCCCAC	DS9
TAGTGGTCACGGACAA	DS6
TAGTGGTCAGGAATCG	DS6
TAGTGGTCATTAGGCT	VU
TAGTGGTGTCGAATCT	DS8
TAGTGGTGTTATGTGC	DS9
TAGTGGTTCCATGCTC	VU
TAGTGGTTCGCGCCAA	DS6
TAGTGGTTCTGAGTGT	DS6
TAGTGGTTCTGGTATG	DS6
TAGTTGGCAAAGGAAG	DS9
TAGTTGGCACGGCGTT	DS8
TAGTTGGCACTCAGGC	DS6
TAGTTGGCAGTGACAG	DS6
TAGTTGGCATTCTTAC	DS7
TAGTTGGGTAGCGCAA	DS3
TAGTTGGGTCCAGTAT	DS6
TAGTTGGTCGCAAACT	DS8
TAGTTGGTCTCTGCTG	DS7
TAGTTGGTCTGGTTCC	DS8
TATCAGGAGAAGATTC	DS6
TATCAGGAGAAGGCCT	DS3
TATCAGGAGACACTAA	DS8
TATCAGGAGCTACCGC	DS8
TATCAGGCACGGCTAC	DS8
TATCAGGCAGTCCTTC	DS3
TATCAGGCATACTCTT	DS3
TATCAGGCATGCTAGT	DS6
TATCAGGGTAGGCTGA	DS9
TATCAGGGTATTAGCC	DS7
TATCAGGGTTCGGCAC	DS9
TATCAGGGTTGGTGGA	DS7
TATCTCAAGCCCTAAT	DS8
TATCTCAAGTAAGTAC	DS3
TATCTCACATCATCCC	DS6
TATCTCACATTAGCCA	DS7
TATCTCAGTAATCGTC	DS6
TATCTCATCACAGTAC	DS7
TATCTCATCGCATGAT	DS6
TATGCCCAGATGGCGT	DS6
TATGCCCCAAGAAAGG	DS8
TATGCCCCATACAGCT	DS8
TATGCCCGTAAACCTC	DS9
TATGCCCTCTCATTCA	DS6
TATGCCCTCTTTACGT	DS6
TATTACCAGGACATTA	VU
TATTACCCACTGAAGG	DS6
TATTACCCATACGCTA	DS6
TATTACCCATCGGGTC	DS8
TATTACCCATGAAGTA	DS6
TATTACCGTGGCAAAC	DS7
TATTACCTCCACGCAG	DS8
TCAACGAAGGTGTGGT	DS6
TCAACGAAGTCTTGCA	DS3
TCAACGACAATCGAAA	DS3
TCAACGACAGGTCCAC	DS7
TCAACGAGTCGAGTTT	DS3
TCAACGAGTTTGACAC	DS8
TCAACGATCACAGGCC	DS8
TCAACGATCCAAAGTC	DS6
TCAACGATCCACTGGG	DS8
TCAACGATCCGTAGGC	VU
TCAACGATCGTCTGCT	DS3
TCAATCTAGACCACGA	DS7
TCAATCTAGCTCAACT	DS6
TCAATCTAGGGATACC	DS6
TCAATCTAGTTACCCA	DS6
TCAATCTCACCAGGCT	DS9
TCAATCTCACTTACGA	DS6
TCAATCTCATCGATTG	DS8
TCAATCTTCATGCTCC	DS7
TCAATCTTCCCTCTTT	DS6
TCAATCTTCGAGGTAG	DS8
TCACAAGAGACGCACA	DS7
TCACAAGAGTGTCCCG	DS8
TCACAAGAGTGTGAAT	DS6
TCACAAGCAAAGGCGT	DS6
TCACAAGCAATGTAAG	DS3
TCACAAGCAGATCGGA	DS6
TCACAAGCAGCTATTG	DS6
TCACAAGGTACCATCA	DS8
TCACAAGGTACTTAGC	DS9
TCACAAGGTCAATACC	DS3
TCACAAGGTCCAGTGC	VU
TCACAAGTCATACGGT	DS8
TCACAAGTCGGATGTT	DS6
TCACAAGTCTGCCCTA	VU
TCACAAGTCTTGTCAT	DS6
TCACGAAAGGAGCGAG	DS9
TCACGAACAAAGTCAA	DS6
TCACGAACAAGAAAGG	DS3
TCACGAACACCAGTTA	DS9
TCACGAACAGTCGATT	DS9
TCACGAACATTACGAC	DS6
TCACGAAGTAGGGTAC	DS8
TCACGAAGTATCACCA	VU
TCACGAAGTCTCGTTC	DS9
TCACGAATCAAGCCTA	DS6
TCACGAATCAGATAAG	DS3
TCACGAATCGTAGGTT	DS8
TCAGATGAGATATGGT	DS6
TCAGATGAGTGAACAT	DS9
TCAGATGCACTGTTAG	DS8
TCAGATGCAGTAACGG	DS9
TCAGATGGTACCGAGA	DS9
TCAGATGGTACCGTAT	DS7
TCAGATGGTAGCGTAG	DS3
TCAGATGGTCGATTGT	VU
TCAGATGGTCGCCATG	DS8
TCAGATGTCATGTGGT	DS8
TCAGATGTCCAGAGGA	DS6
TCAGATGTCGTAGATC	DS8
TCAGATGTCTGTCCGT	DS8
TCAGATGTCTTGTATC	DS8
TCAGCAAAGACAGACC	DS3
TCAGCAAAGAGCCTAG	DS6
TCAGCAAAGATACACA	DS3
TCAGCAAAGTGAACAT	VU
TCAGCAACAGCATACT	DS7
TCAGCAACAGTATAAG	DS6
TCAGCAAGTTCCGGCA	DS6
TCAGCAAGTTCTGTTT	DS8
TCAGCAATCAGCCTAA	DS7
TCAGCTCAGCGACGTA	DS8
TCAGCTCAGGAGCGAG	DS9
TCAGCTCAGTAGGCCA	DS9
TCAGCTCCACCTGGTG	VU
TCAGCTCCAGGGATTG	VU
TCAGCTCCATTCACTT	DS7
TCAGCTCGTATAGGGC	DS6
TCAGCTCGTCAAAGAT	DS7
TCAGCTCGTTTCCACC	DS3
TCAGCTCTCAGCGACC	DS9
TCAGCTCTCCAAATGC	DS8
TCAGCTCTCCACGCAG	VU
TCAGCTCTCGACCAGC	DS8
TCAGGATAGCTAGTCT	VU
TCAGGATCACAACTGT	VU
TCAGGATCACAGTCGC	VU
TCAGGATCACCCATTC	DS6
TCAGGATCATCCCACT	DS9
TCAGGATGTCATCCCT	DS7
TCAGGATTCGTAGGTT	DS6
TCAGGATTCTACTTAC	DS8
TCAGGTAAGAATGTGT	VU
TCAGGTAAGTGAACGC	DS9
TCAGGTACAAAGCGGT	DS9
TCAGGTACAGCTTCGG	DS7
TCAGGTAGTAAACCTC	DS7
TCAGGTAGTGAAATCA	DS7
TCAGGTATCGTCCAGG	DS8
TCATTACAGCTAACTC	DS8
TCATTACAGTCAAGCG	DS7
TCATTACCAAAGGAAG	DS6
TCATTACCACGTGAGA	DS6
TCATTACCATAGACTC	DS6
TCATTACGTACCGCTG	DS8
TCATTACGTCCGTCAG	DS6
TCATTACGTCTAGTCA	DS8
TCATTACGTGATGTCT	DS7
TCATTACGTGCGCTTG	DS6
TCATTACGTGGTTTCA	DS6
TCATTACGTTGGAGGT	DS8
TCATTACTCATAGCAC	DS6
TCATTACTCCCTCTTT	VU
TCATTTGAGCAGACTG	DS6
TCATTTGCAATCCGAT	DS9
TCATTTGCACAGATTC	VU
TCATTTGCACGAGAGT	DS8
TCATTTGCACTAAGTC	DS8
TCATTTGCATAACCTG	DS8
TCATTTGCATCTATGG	DS3
TCATTTGGTCAGTGGA	VU
TCATTTGGTCCGTCAG	DS6
TCATTTGGTTTGGCGC	DS3
TCATTTGTCCGCGGTA	DS7
TCATTTGTCTAAGCCA	DS9
TCCACACAGCCACCTG	DS8
TCCACACAGTGCCATT	DS3
TCCACACCAAGACACG	DS7
TCCACACCACAGCGTC	DS8
TCCACACCACATGACT	DS8
TCCACACCAGCTCCGA	DS9
TCCACACGTCCTCTTG	DS7
TCCACACGTCGCGTGT	DS8
TCCACACGTGATGTCT	DS8
TCCACACGTTCGTGAT	DS9
TCCACACTCCTATGTT	DS9
TCCCGATAGAATGTGT	DS8
TCCCGATAGAGGTTGC	DS8
TCCCGATAGGCGACAT	DS9
TCCCGATAGGGATGGG	DS8
TCCCGATCAAACGCGA	DS6
TCCCGATTCATTTGGG	DS9
TCCCGATTCCACTGGG	DS7
TCCCGATTCGAACTGT	DS7
TCCCGATTCGAGCCCA	DS7
TCGAGGCAGAAGGGTA	DS8
TCGAGGCAGACTGGGT	DS7
TCGAGGCAGAGTCTGG	DS6
TCGAGGCAGATGTAAC	DS9
TCGAGGCAGCTAAACA	DS7
TCGAGGCAGGGATACC	DS6
TCGAGGCCAATAACGA	DS3
TCGAGGCCACCATGTA	DS6
TCGAGGCGTAGGAGTC	DS8
TCGAGGCGTCTGGTCG	DS6
TCGAGGCGTGGTCTCG	DS9
TCGAGGCTCCAGAGGA	DS9
TCGAGGCTCCGCATAA	DS3
TCGAGGCTCCGCATCT	DS6
TCGAGGCTCGGCCGAT	DS6
TCGCGAGAGACAGACC	DS9
TCGCGAGAGCCGGTAA	DS6
TCGCGAGAGCGTGAAC	DS6
TCGCGAGAGGCTATCT	DS3
TCGCGAGAGTACGCCC	DS8
TCGCGAGAGTTATCGC	VU
TCGCGAGCAAGTCTAC	DS6
TCGCGAGCAATTGCTG	DS9
TCGCGAGCACAGGAGT	DS3
TCGCGAGCAGCAGTTT	DS6
TCGCGAGCATACAGCT	DS8
TCGCGAGCATACGCTA	DS3
TCGCGAGCATCCGTGG	DS7
TCGCGAGGTCTGCCAG	DS7
TCGCGAGGTGCGATAG	DS9
TCGCGAGGTTCAGTAC	DS7
TCGCGAGTCGCATGAT	DS8
TCGCGAGTCGTAGATC	DS3
TCGCGAGTCTGTCTCG	DS8
TCGCGAGTCTTTAGTC	DS6
TCGCGTTAGTGGTAGC	VU
TCGCGTTCAATTGCTG	DS6
TCGCGTTCACCTTGTC	DS8
TCGCGTTCACGTTGGC	DS6
TCGCGTTCAGCGTCCA	DS8
TCGCGTTCAGGCGATA	DS6
TCGCGTTCATCGATTG	DS8
TCGCGTTCATCTATGG	DS3
TCGCGTTGTAATAGCA	DS8
TCGCGTTGTAGCCTCG	DS3
TCGCGTTGTCATACTG	DS8
TCGCGTTGTCCGAACC	VU
TCGCGTTGTGCAGGTA	DS9
TCGCGTTGTTCACCTC	VU
TCGCGTTGTTGGTAAA	DS8
TCGCGTTTCAGGTAAA	DS9
TCGCGTTTCCGTCATC	DS7
TCGCGTTTCTATCCTA	DS7
TCGGGACAGAAACCAT	DS8
TCGGGACAGAACTGTA	DS3
TCGGGACAGCCGATTT	DS9
TCGGGACAGTCGTACT	VU
TCGGGACCAATCAGAA	DS3
TCGGGACCACCAGGCT	DS6
TCGGGACCATGAAGTA	DS9
TCGGGACGTAAGTGTA	DS3
TCGGGACGTAGGCTGA	VU
TCGGGACGTGTAACGG	DS3
TCGGGACTCACTGGGC	DS8
TCGGGACTCATAAAGG	DS8
TCGGGACTCCTCCTAG	DS7
TCGGGACTCGGCGCAT	DS6
TCGGGACTCTACTTAC	DS7
TCGGTAAAGCCAGTTT	DS6
TCGGTAAAGGATTCGG	DS6
TCGGTAAAGGCTAGGT	DS7
TCGGTAAAGGTGTTAA	DS6
TCGGTAACAACCGCCA	DS6
TCGGTAACAAGTTCTG	DS6
TCGGTAACACGACTCG	DS6
TCGGTAAGTACCGTAT	DS9
TCGGTAAGTGCTTCTC	DS8
TCGGTAAGTGTGGCTC	DS3
TCGGTAATCACCATAG	DS9
TCGGTAATCATGCATG	DS9
TCGGTAATCCACGACG	DS8
TCGGTAATCGACGGAA	DS7
TCGGTAATCTGAAAGA	DS3
TCGTACCAGAGTAATC	DS7
TCGTACCAGAGTACCG	DS8
TCGTACCAGCAGACTG	DS7
TCGTACCAGGACAGCT	DS8
TCGTACCAGGACATTA	DS9
TCGTACCAGTCCAGGA	VU
TCGTACCAGTCTCCTC	DS6
TCGTACCAGTGTACTC	DS7
TCGTACCCAACCGCCA	DS6
TCGTACCCATCGGACC	DS8
TCGTACCCATCTCCCA	DS9
TCGTACCCATGCCTTC	DS9
TCGTACCCATGCTAGT	DS7
TCGTACCGTCGCGAAA	DS7
TCGTACCGTCTGATCA	DS6
TCGTACCGTGCAGTAG	DS3
TCGTACCGTGTTGGGA	DS3
TCGTACCTCCAAAGTC	DS8
TCGTACCTCCACTGGG	DS8
TCGTACCTCCAGTATG	DS7
TCGTACCTCCTCAATT	DS3
TCGTAGAAGGAGCGAG	DS6
TCGTAGAAGGGTTTCT	DS9
TCGTAGAAGTAAGTAC	DS7
TCGTAGACACATGACT	DS6
TCGTAGACACGTGAGA	DS9
TCGTAGACAGTATGCT	DS6
TCGTAGACATCTATGG	DS6
TCGTAGAGTGCACGAA	DS3
TCGTAGATCGTAGATC	DS6
TCGTAGATCTCTGTCG	DS3
TCTATTGCATACAGCT	DS8
TCTATTGGTAAACGCG	DS7
TCTATTGGTACAGTTC	VU
TCTATTGGTGATAAAC	VU
TCTATTGTCAGAGCTT	DS3
TCTATTGTCAGCTTAG	DS8
TCTATTGTCCACGCAG	DS7
TCTATTGTCCATGAGT	DS7
TCTATTGTCCGCGTTT	DS7
TCTATTGTCGCTTAGA	DS8
TCTATTGTCGGTTCGG	DS6
TCTATTGTCTTATCTG	DS6
TCTATTGTCTTTCCTC	DS6
TCTCATAAGAGAGCTC	DS8
TCTCATAAGGAATTAC	DS6
TCTCATAAGTAGCCGA	DS6
TCTCATACAATAGCAA	DS8
TCTCATACAATCAGAA	DS6
TCTCATACACGGCTAC	DS3
TCTCATACAGACGCAA	DS9
TCTCATACAGCCTTGG	DS7
TCTCATACAGGTCCAC	DS6
TCTCATAGTACGACCC	DS6
TCTCATAGTGGAAAGA	DS7
TCTCATATCAACGAAA	DS6
TCTCATATCCTCTAGC	DS6
TCTCATATCTGTTTGT	DS7
TCTCTAACAAATTGCC	DS6
TCTCTAACACAACGCC	DS6
TCTCTAACACAGGTTT	DS3
TCTCTAACAGTATGCT	VU
TCTCTAAGTCTCCCTA	DS8
TCTCTAAGTGGTCCGT	DS6
TCTCTAAGTTATCCGA	DS6
TCTCTAAGTTCATGGT	DS9
TCTGAGAAGACTGTAA	DS6
TCTGAGAAGGTAAACT	DS7
TCTGAGACACTTGGAT	DS6
TCTGAGACAGTAGAGC	DS7
TCTGAGACATACCATG	DS9
TCTGAGACATGCAACT	DS6
TCTGAGAGTACTCGCG	DS7
TCTGAGAGTCGCGTGT	DS3
TCTGAGAGTTGTACAC	DS9
TCTGAGATCCAAACTG	DS6
TCTGAGATCCTTTACA	DS8
TCTGGAAAGGACCACA	DS6
TCTGGAAAGGTGATAT	DS7
TCTGGAAAGGTTACCT	DS3
TCTGGAAAGTTGTCGT	VU
TCTGGAACACCGCTAG	DS9
TCTGGAACAGATAATG	DS9
TCTGGAACATTCTTAC	DS7
TCTGGAAGTCAGAGGT	DS8
TCTGGAAGTTACGGAG	DS8
TCTGGAAGTTTGCATG	DS8
TCTTCGGAGCCCAACC	DS8
TCTTCGGAGGGCTTCC	DS7
TCTTCGGAGTACGTAA	DS9
TCTTCGGAGTCACGCC	DS7
TCTTCGGCAATCGGTT	VU
TCTTCGGCACCAGGTC	DS8
TCTTCGGCAGGATTGG	DS6
TCTTCGGCAGTGAGTG	DS3
TCTTCGGCAGTTAACC	DS7
TCTTCGGCAGTTCCCT	DS9
TCTTCGGCATGTAGTC	DS8
TCTTCGGGTATAGGGC	DS8
TCTTCGGGTCGGATCC	DS6
TCTTCGGGTGATGCCC	DS8
TCTTCGGTCATGTCCC	DS3
TCTTCGGTCGGATGGA	DS8
TCTTTCCAGTGTACCT	DS8
TCTTTCCAGTTGAGAT	DS3
TCTTTCCCAGAGTGTG	DS8
TCTTTCCCATCGGGTC	DS6
TCTTTCCGTAAATACG	DS7
TCTTTCCGTAGCGCAA	DS7
TCTTTCCGTTCGCTAA	DS7
TCTTTCCTCAAAGTAG	DS8
TCTTTCCTCCATGAAC	DS9
TCTTTCCTCGAATGCT	DS7
TCTTTCCTCTGCTTGC	DS6
TGAAAGAAGCTAGGCA	DS9
TGAAAGACATTTGCCC	DS7
TGAAAGATCAACCATG	DS6
TGAAAGATCCGGGTGT	DS3
TGAAAGATCGTAGGTT	DS8
TGACAACAGAGTAATC	DS9
TGACAACAGGACCACA	DS6
TGACAACAGGTGTGGT	DS6
TGACAACCAATAGCGG	DS3
TGACAACCACGAGGTA	DS3
TGACAACCACGCATCG	DS7
TGACAACCAGGGTATG	VU
TGACAACGTACTTCTT	DS7
TGACAACGTCGCATAT	DS3
TGACAACGTTCGCGAC	VU
TGACAACTCGGAAACG	VU
TGACGGCAGACTGGGT	DS6
TGACGGCAGAGCTGCA	DS9
TGACGGCAGGTGATTA	VU
TGACGGCAGTGCTGCC	DS6
TGACGGCGTAATAGCA	DS8
TGACGGCGTACCGAGA	DS7
TGACGGCGTAGCCTAT	DS6
TGACGGCGTGCTCTTC	DS6
TGACGGCTCCTGCAGG	DS8
TGACGGCTCCTGTACC	DS8
TGACGGCTCGAGAGCA	DS3
TGACGGCTCTACGAGT	DS6
TGACGGCTCTAGCACA	DS8
TGACTAGAGAAGGCCT	DS7
TGACTAGAGCGCCTCA	VU
TGACTAGCAGCTGGCT	DS9
TGACTAGGTAAATGTG	DS9
TGACTAGGTAATAGCA	DS8
TGACTAGGTAGCGATG	DS7
TGACTAGGTGCACTTA	DS6
TGACTAGTCACGACTA	DS6
TGACTAGTCCGCGTTT	DS7
TGACTAGTCGTTGACA	DS7
TGACTTTAGACTAGAT	DS7
TGACTTTAGAGACGAA	DS7
TGACTTTAGGAGCGTT	DS7
TGACTTTCAAGTTAAG	DS7
TGACTTTCAATTCCTT	VU
TGACTTTCACCTATCC	DS6
TGACTTTCACGGTAAG	DS7
TGACTTTCATAGACTC	DS6
TGACTTTGTCCGAACC	VU
TGACTTTGTCGTTGTA	DS3
TGACTTTGTGTGTGCC	DS6
TGACTTTGTTTGGGCC	VU
TGACTTTTCACTATTC	DS6
TGACTTTTCATAACCG	DS6
TGACTTTTCCGTAGTA	DS9
TGACTTTTCGTTACAG	DS3
TGACTTTTCTCGCTTG	DS3
TGACTTTTCTTTAGTC	DS9
TGAGAGGAGAGGGCTT	DS9
TGAGAGGAGTACGCGA	DS6
TGAGAGGAGTCAAGCG	DS9
TGAGAGGAGTGACTCT	VU
TGAGAGGCAACTGGCC	DS7
TGAGAGGCATACGCCG	DS8
TGAGAGGGTAAATGTG	DS6
TGAGAGGGTACACCGC	VU
TGAGAGGGTCAATGTC	DS6
TGAGAGGTCACGGTTA	DS6
TGAGAGGTCATCGCTC	DS9
TGAGAGGTCCCATTTA	DS6
TGAGAGGTCGCCTGTT	DS6
TGAGAGGTCGTCCAGG	DS9
TGAGAGGTCTATGTGG	DS7
TGAGAGGTCTCGAGTA	VU
TGAGAGGTCTGAAAGA	DS8
TGAGCATAGACTGGGT	DS6
TGAGCATAGCCACGCT	DS8
TGAGCATAGCTAAACA	DS6
TGAGCATAGTGGAGTC	DS7
TGAGCATAGTGGGATC	VU
TGAGCATGTGGCCCTA	VU
TGAGCATGTTACGGAG	DS3
TGAGCATTCAGCACAT	DS6
TGAGCCGAGAGAGCTC	DS3
TGAGCCGAGGCCCTCA	DS9
TGAGCCGAGTTCGATC	DS9
TGAGCCGCATCACCCT	VU
TGAGCCGGTCCGTGAC	DS9
TGAGCCGGTCGCATAT	DS7
TGAGCCGGTCTCTCTG	DS9
TGAGCCGGTGGGTCAA	DS6
TGAGCCGGTTCCACAA	DS7
TGAGCCGGTTGCCTCT	VU
TGAGCCGTCAAGAAGT	VU
TGAGCCGTCAAGCCTA	DS9
TGAGCCGTCATGCATG	DS6
TGAGCCGTCGCGGATC	DS9
TGAGGGAAGAGACTAT	DS9
TGAGGGAAGAGCTGCA	DS7
TGAGGGAAGCCGCCTA	VU
TGAGGGAAGCGATATA	DS7
TGAGGGAAGTGCGTGA	DS3
TGAGGGACAAGCCATT	DS7
TGAGGGACAGGTCTCG	VU
TGAGGGACATTACCTT	DS7
TGAGGGAGTGGTACAG	DS6
TGAGGGATCAGCCTAA	DS7
TGAGGGATCCGCAAGC	DS7
TGAGGGATCTAACGGT	DS3
TGAGGGATCTGCCAGG	DS3
TGATTTCAGACAAGCC	DS6
TGATTTCAGTGGGTTG	DS8
TGATTTCCAAGACGTG	DS7
TGATTTCCACTTCGAA	DS7
TGATTTCCAGCTCCGA	DS6
TGATTTCCAGTAAGCG	DS8
TGATTTCGTACTCTCC	DS9
TGATTTCGTAGGCTGA	DS7
TGATTTCGTATAAACG	DS7
TGATTTCTCAACGGGA	DS6
TGATTTCTCAGTTTGG	DS9
TGATTTCTCATCGGAT	DS6
TGCACCTAGCTCCTTC	DS3
TGCACCTCAGTCAGCC	DS6
TGCACCTCATGGAATA	DS7
TGCACCTGTATGAATG	DS6
TGCACCTGTCATTAGC	DS7
TGCACCTGTCCGTGAC	DS7
TGCACCTGTCTCCACT	DS6
TGCACCTGTGTTGAGG	DS6
TGCACCTGTTAAGAAC	DS6
TGCACCTGTTCCAACA	DS7
TGCACCTTCACCAGGC	DS8
TGCACCTTCGTTTATC	DS7
TGCCAAAAGATCCCGC	VU
TGCCAAAAGGATGGTC	DS8
TGCCAAACAAAGAATC	DS8
TGCCAAACACTATCTT	DS8
TGCCAAACATGACGGA	DS6
TGCCAAACATGAGCGA	DS6
TGCCAAACATTCCTGC	DS6
TGCCAAAGTCGAATCT	DS6
TGCCAAAGTCGTTGTA	DS6
TGCCCATAGACAAAGG	DS6
TGCCCATAGCACCGCT	DS6
TGCCCATAGCTTTGGT	DS6
TGCCCATAGGAGCGAG	DS6
TGCCCATAGGCGACAT	DS6
TGCCCATAGGGAACGG	DS6
TGCCCATAGTAAGTAC	DS8
TGCCCATCAATGACCT	DS6
TGCCCATGTTATCACG	DS7
TGCCCATTCAAGGCTT	DS8
TGCCCATTCACTGGGC	DS8
TGCCCATTCCTTTCTC	DS3
TGCCCATTCTCATTCA	DS7
TGCCCATTCTTCCTTC	DS7
TGCCCTAAGGGTTTCT	DS9
TGCCCTACAATGTAAG	DS6
TGCCCTACAGCCTGTG	DS6
TGCCCTACAGCTGCTG	DS7
TGCCCTATCAAACCGT	DS6
TGCCCTATCCTTGCCA	DS6
TGCCCTATCGGTCTAA	DS8
TGCCCTATCGTAGATC	DS9
TGCCCTATCTTTAGGG	VU
TGCGCAGAGTGGGTTG	VU
TGCGCAGAGTTGAGTA	DS7
TGCGCAGCACAAGTAA	DS6
TGCGCAGCACATGTGT	DS7
TGCGCAGGTATAAACG	DS8
TGCGCAGGTCATATCG	DS7
TGCGCAGGTGGCTCCA	DS9
TGCGCAGTCAGCTGGC	DS3
TGCGCAGTCCGCATAA	DS7
TGCGCAGTCCGTCATC	DS7
TGCGCAGTCGTTTGCC	DS3
TGCGGGTAGACTAGGC	DS8
TGCGGGTAGGATCGCA	VU
TGCGGGTAGTCAAGCG	DS6
TGCGGGTAGTGGAGTC	DS6
TGCGGGTCACTTCGAA	DS9
TGCGGGTTCAGCTTAG	DS7
TGCGGGTTCAGTGCAT	DS6
TGCGGGTTCCGTAGGC	DS9
TGCGGGTTCGTGGACC	DS7
TGCGGGTTCTAACTGG	VU
TGCGGGTTCTACGAGT	DS8
TGCGGGTTCTGGTGTA	DS6
TGCGTGGAGACTGGGT	DS6
TGCGTGGAGCGGATCA	DS7
TGCGTGGAGTGTTTGC	DS9
TGCGTGGCAATGACCT	DS9
TGCGTGGCACGAGAGT	VU
TGCGTGGCACTTCGAA	DS9
TGCGTGGGTCCGACGT	DS3
TGCGTGGGTCTTCTCG	DS9
TGCGTGGTCCTAAGTG	DS7
TGCGTGGTCCTAGAAC	DS6
TGCTACCAGACTACAA	DS8
TGCTACCAGTGTTTGC	DS6
TGCTACCCACGGTGTC	DS6
TGCTACCGTAAGTGTA	DS6
TGCTACCGTATATGAG	DS6
TGCTACCTCCCGGATG	DS7
TGCTACCTCTAGCACA	DS8
TGCTACCTCTCCAGGG	DS9
TGCTGCTAGGATGGAA	DS7
TGCTGCTAGGCTAGGT	DS8
TGCTGCTCACGAGAGT	DS6
TGCTGCTCAGACGCCT	DS8
TGCTGCTCAGTAAGCG	DS8
TGCTGCTGTACCGAGA	DS9
TGCTGCTGTACTTAGC	DS7
TGCTGCTGTAGCGATG	VU
TGCTGCTGTCCGAAGA	VU
TGCTGCTGTGTGTGCC	DS6
TGCTGCTTCAACACGT	VU
TGCTGCTTCCACGACG	DS6
TGCTGCTTCGCCGTGA	DS8
TGCTGCTTCTTAGCCC	DS6
TGGACGCAGGGCACTA	DS7
TGGACGCAGTTAACGA	DS3
TGGACGCCAATAGCAA	DS8
TGGACGCCAGCTGTGC	DS6
TGGACGCGTCCTGCTT	DS8
TGGACGCGTTATCGGT	DS6
TGGACGCGTTGTTTGG	DS8
TGGACGCTCTATCCCG	DS6
TGGACGCTCTGGAGCC	DS3
TGGACGCTCTTAGCCC	DS6
TGGACGCTCTTTAGTC	DS6
TGGCCAGAGAAGGTTT	VU
TGGCCAGAGCTGAAAT	DS3
TGGCCAGAGTGGGATC	DS9
TGGCCAGCACCGAATT	DS8
TGGCCAGCAGCTATTG	DS7
TGGCCAGCAGTCCTTC	DS6
TGGCCAGCATACGCCG	DS6
TGGCCAGGTATCACCA	DS9
TGGCCAGGTCATATCG	DS3
TGGCCAGGTGAAATCA	DS8
TGGCCAGGTGACTCAT	DS7
TGGCCAGTCACCCGAG	DS6
TGGCCAGTCAGAGACG	DS6
TGGCCAGTCTGCAAGT	DS6
TGGCGCACACAGAGGT	DS9
TGGCGCAGTACTCAAC	DS6
TGGCGCATCAAGGCTT	DS8
TGGCGCATCCAAGCCG	DS6
TGGCGCATCCGCAAGC	DS7
TGGCGCATCTCACATT	DS8
TGGCGCATCTTGTACT	DS7
TGGCTGGAGAATGTGT	DS6
TGGCTGGAGACTAGAT	DS7
TGGCTGGAGCACGCCT	DS7
TGGCTGGAGTTGTAGA	DS7
TGGCTGGCACGCGAAA	DS7
TGGCTGGGTAAGTTCC	DS7
TGGCTGGGTATTCGTG	DS6
TGGCTGGGTCCGAACC	DS3
TGGCTGGGTCGCGGTT	DS6
TGGCTGGGTTCACGGC	DS6
TGGCTGGTCATTGCCC	DS7
TGGCTGGTCTCTAGGA	DS6
TGGGAAGAGCCCAATT	DS9
TGGGAAGAGCTATGCT	DS3
TGGGAAGAGGACTGGT	DS9
TGGGAAGAGTGCGATG	DS7
TGGGAAGCAGTAAGCG	DS7
TGGGAAGGTCAGAAGC	DS3
TGGGAAGGTGGTGTAG	DS8
TGGGAAGTCAACGGGA	DS6
TGGGAAGTCATACGGT	DS7
TGGGAAGTCCTACAGA	DS6
TGGGAAGTCTCAAACG	DS6
TGGGAAGTCTGTCTCG	DS8
TGGGCGTAGATGTGGC	DS3
TGGGCGTAGCTAACTC	DS3
TGGGCGTAGGCACATG	VU
TGGGCGTCAGGGTTAG	DS6
TGGGCGTGTAAGTAGT	DS8
TGGGCGTGTACATCCA	DS8
TGGGCGTGTACCGAGA	DS3
TGGGCGTGTATTCTCT	DS8
TGGGCGTGTGTCAATC	DS6
TGGGCGTGTTAAGACA	DS8
TGGGCGTGTTCCACAA	DS6
TGGGCGTTCAACACTG	DS8
TGGGCGTTCGAGAACG	DS3
TGGGCGTTCGCGTAGC	VU
TGGGCGTTCGTACGGC	DS8
TGGTTAGAGACACGAC	DS8
TGGTTAGGTCTTGATG	DS9
TGGTTAGTCACTTATC	DS9
TGGTTAGTCATGTGGT	VU
TGGTTAGTCCAAGTAC	VU
TGGTTCCAGACCTTTG	DS7
TGGTTCCAGCAATCTC	DS6
TGGTTCCAGCCTCGTG	DS7
TGGTTCCAGGACAGAA	VU
TGGTTCCCAGCTGTAT	DS3
TGGTTCCGTACAGTGG	DS7
TGGTTCCGTAGCCTAT	DS7
TGGTTCCGTATGGTTC	DS3
TGGTTCCGTCCCTACT	DS8
TGGTTCCGTGGGTCAA	DS6
TGGTTCCTCCATTCTA	DS9
TGGTTCCTCCGCTGTT	DS8
TGTATTCAGAAGGGTA	DS8
TGTATTCAGACCTAGG	DS3
TGTATTCAGACTGGGT	DS8
TGTATTCAGCGTTTAC	DS7
TGTATTCAGCTAGTGG	DS9
TGTATTCAGCTGCGAA	DS3
TGTATTCAGGGAAACA	DS3
TGTATTCAGGTTCCTA	DS6
TGTATTCCAAGCCGTC	VU
TGTATTCCAAGCGATG	DS6
TGTATTCCAAGGACAC	VU
TGTATTCCAGGACCCT	DS8
TGTATTCCATATGAGA	DS8
TGTATTCGTGGACGAT	DS8
TGTATTCGTTAAGATG	DS6
TGTATTCGTTCAGTAC	DS9
TGTATTCTCACGAAGG	DS9
TGTATTCTCACGCATA	DS6
TGTATTCTCATAGCAC	DS7
TGTATTCTCCGCATCT	DS7
TGTATTCTCGGATGGA	DS9
TGTCCCAAGAAGATTC	DS6
TGTCCCAAGATCACGG	DS3
TGTCCCAAGGACGAAA	DS3
TGTCCCAAGGATCGCA	DS3
TGTCCCAAGGGCACTA	DS7
TGTCCCAAGTCTCAAC	DS8
TGTCCCACAAAGCAAT	VU
TGTCCCACACCAGTTA	DS8
TGTCCCACAGGGTACA	DS9
TGTCCCACAGTAACGG	DS7
TGTCCCACATGTAGTC	DS9
TGTCCCAGTAATCACC	DS3
TGTCCCAGTAGGAGTC	VU
TGTCCCAGTAGTGAAT	DS9
TGTCCCAGTCCCGACA	DS7
TGTCCCAGTCGCGAAA	DS6
TGTCCCATCACAATGC	DS3
TGTCCCATCCAACCAA	DS3
TGTCCCATCGTAGGTT	DS7
TGTCCCATCGTCTGAA	DS6
TGTCCCATCTGGTTCC	DS6
TGTGGTAAGAGACTAT	DS3
TGTGGTAAGCTTCGCG	DS7
TGTGGTAAGTCAAGCG	DS6
TGTGGTACAGGGTACA	DS3
TGTGGTACATCACCCT	DS6
TGTGGTAGTACTTCTT	DS8
TGTGGTAGTGAGGCTA	DS8
TGTGGTAGTTGACGTT	DS6
TGTGGTAGTTGCCTCT	DS7
TGTGGTAGTTGCGTTA	DS7
TGTGGTATCCACGCAG	DS8
TGTGTTTAGAGACGAA	DS3
TGTGTTTAGAGGTTGC	DS7
TGTGTTTCAGACGCAA	DS8
TGTGTTTCAGCCAGAA	DS6
TGTGTTTGTACAGTGG	VU
TGTGTTTGTGTTTGTG	DS7
TGTGTTTGTTAAAGAC	DS7
TGTGTTTGTTACGCGC	VU
TGTGTTTTCACCACCT	DS9
TGTGTTTTCCACGACG	VU
TGTGTTTTCCTATTCA	DS8
TGTGTTTTCCTGCTTG	DS3
TGTGTTTTCCTTTCTC	DS6
TGTGTTTTCTCGGACG	DS8
TGTTCCGAGAGGTAGA	DS3
TGTTCCGAGCTGAAAT	DS8
TGTTCCGAGCTGCAAG	DS9
TGTTCCGAGTTACCCA	DS7
TGTTCCGCACATAACC	DS8
TGTTCCGCACCACCAG	DS3
TGTTCCGGTAGCCTAT	DS9
TGTTCCGGTGTTTGGT	DS9
TGTTCCGTCAACGAAA	DS6
TGTTCCGTCCTAGTGA	DS9
TGTTCCGTCGCCTGTT	DS3
TGTTCCGTCTGCCAGG	DS9
TTAACTCAGCCCTAAT	DS7
TTAACTCAGGGATGGG	DS6
TTAACTCCACCTCGTT	DS8
TTAACTCCAGTAACGG	DS6
TTAACTCCAGTCACTA	DS3
TTAACTCGTTGTGGCC	DS3
TTAACTCGTTTCGCTC	VU
TTAACTCTCAAGATCC	DS6
TTAACTCTCATGTCCC	VU
TTAACTCTCGAATGCT	DS6
TTAGGACAGATCACGG	DS6
TTAGGACAGCACCGCT	DS8
TTAGGACAGCTATGCT	DS9
TTAGGACAGCTGAACG	DS6
TTAGGACAGCTGCGAA	DS9
TTAGGACCACAGTCGC	DS3
TTAGGACCACCCATTC	DS8
TTAGGACCAGATCTGT	DS6
TTAGGACGTGGGTATG	DS7
TTAGGACGTTGACGTT	DS8
TTAGGACTCCAACCAA	DS9
TTAGGACTCGTACCGG	DS8
TTAGGACTCGTAGGTT	DS7
TTAGGCAAGAAAGTGG	DS9
TTAGGCAAGTCTCAAC	VU
TTAGGCACAGAAGCAC	DS8
TTAGGCACAGTCGATT	DS3
TTAGGCACATGCCTAA	DS6
TTAGGCAGTACATGTC	DS8
TTAGGCAGTCTTGATG	DS3
TTAGGCAGTGTGACCC	DS7
TTAGGCAGTTTAGCTG	DS3
TTAGGCATCACGACTA	VU
TTAGGCATCAGAGGTG	DS6
TTAGGCATCCGCATCT	VU
TTAGGCATCCTGCTTG	VU
TTAGGCATCTAGAGTC	DS6
TTAGGCATCTTACCGC	DS7
TTAGGCATCTTCGGTC	DS9
TTAGTTCCACACGCTG	DS6
TTAGTTCCACTTACGA	VU
TTAGTTCCACTTCGAA	DS6
TTAGTTCCATCTATGG	DS3
TTAGTTCGTAACGCGA	VU
TTAGTTCGTCGCATAT	VU
TTAGTTCGTTAGATGA	DS3
TTAGTTCTCAAAGTAG	DS6
TTAGTTCTCTTGCCGT	DS8
TTATGCTAGAAGGACA	DS3
TTATGCTAGGGCACTA	DS8
TTATGCTCAAAGTGCG	VU
TTATGCTCATTACCTT	DS3
TTATGCTCATTCTTAC	VU
TTATGCTGTAGGGTAC	DS6
TTATGCTGTATTCGTG	DS6
TTATGCTTCAAACCAC	VU
TTATGCTTCAGTTGAC	DS7
TTATGCTTCGTTGACA	DS6
TTATGCTTCTTGTCAT	DS6
TTCCCAGAGACTAGAT	DS7
TTCCCAGAGATGGGTC	DS6
TTCCCAGAGTGACTCT	DS7
TTCCCAGCAAGGACTG	DS9
TTCCCAGCACCAACCG	DS7
TTCCCAGCACGCCAGT	DS6
TTCCCAGGTATTAGCC	DS9
TTCCCAGTCGCCAGCA	DS6
TTCCCAGTCGGATGTT	DS8
TTCCCAGTCGTGACAT	DS8
TTCGAAGAGCCCAATT	DS8
TTCGAAGAGTCTTGCA	DS6
TTCGAAGCAGCTGCAC	DS6
TTCGAAGGTCGGGTCT	DS8
TTCGAAGGTCTCTTAT	DS6
TTCGAAGTCTAACTCT	DS9
TTCGAAGTCTACTATC	DS3
TTCGGTCAGAAGGCCT	DS6
TTCGGTCAGCTCCCAG	DS9
TTCGGTCAGTATTGGA	DS8
TTCGGTCAGTTGAGAT	DS9
TTCGGTCCACACAGAG	DS8
TTCGGTCCAGATTGCT	DS3
TTCGGTCCATGTAAGA	VU
TTCGGTCCATGTCTCC	DS8
TTCGGTCTCGCATGGC	DS9
TTCGGTCTCTGTTGAG	VU
TTCTACAAGAAACCGC	DS7
TTCTACAAGGAGTCTG	DS9
TTCTACAAGTGCGTGA	DS9
TTCTACACATGCCTAA	VU
TTCTACACATTCACTT	DS3
TTCTACAGTCAGAGGT	DS9
TTCTACAGTGTAATGA	DS7
TTCTACATCTTGTTTG	DS7
TTCTCAAAGAATGTGT	DS8
TTCTCAAAGAATGTTG	DS6
TTCTCAAAGGAATGGA	DS9
TTCTCAAAGGGAGTAA	DS8
TTCTCAACACAACGCC	DS6
TTCTCAACAGCTCGAC	DS7
TTCTCAACATATACGC	DS7
TTCTCAAGTATATCCG	DS3
TTCTCAAGTCGGGTCT	DS3
TTCTCAAGTCTTGTCC	DS9
TTCTCAAGTGCTAGCC	DS6
TTCTCCTAGAGTCTGG	DS3
TTCTCCTAGGAGTCTG	VU
TTCTCCTAGGTCGGAT	DS9
TTCTCCTAGTGATCGG	DS6
TTCTCCTAGTTGTCGT	DS8
TTCTCCTCAAGAAGAG	DS8
TTCTCCTCAGTGGGAT	DS3
TTCTCCTGTCGTGGCT	DS7
TTCTCCTTCTGAAAGA	DS8
TTCTCCTTCTGTCAAG	DS8
TTCTTAGAGGACATTA	VU
TTCTTAGAGGCCCTTG	DS6
TTCTTAGAGTTATCGC	DS8
TTCTTAGCAAAGGAAG	DS3
TTCTTAGCAAATCCGT	DS7
TTCTTAGCAATAGCAA	DS9
TTCTTAGCACGGCTAC	DS8
TTCTTAGGTACAGTTC	DS6
TTCTTAGGTGCACGAA	DS6
TTCTTAGGTGCGGTAA	DS7
TTCTTAGTCAGTACGT	DS6
TTCTTAGTCCGCGCAA	DS8
TTCTTAGTCCGGCACA	DS6
TTCTTAGTCTCCTATA	DS6
TTGAACGAGAACTCGG	DS6
TTGAACGAGAAGGTTT	DS3
TTGAACGAGATAGCAT	VU
TTGAACGAGTGACATA	DS6
TTGAACGCAAGCCCAC	DS9
TTGAACGCAATCCAAC	DS6
TTGAACGCACTGCCAG	DS9
TTGAACGGTCCGCTGA	DS7
TTGAACGGTCGGCTCA	DS6
TTGAACGGTTATTCTC	DS6
TTGAACGGTTCGAATC	DS6
TTGAACGTCCGTAGGC	DS6
TTGAACGTCTTCATGT	DS8
TTGACTTAGAAGCCCA	VU
TTGACTTAGCTAGTCT	DS9
TTGACTTAGGACATTA	DS3
TTGACTTAGGCTAGAC	DS8
TTGACTTAGTGTCTCA	VU
TTGACTTGTACTCGCG	DS6
TTGACTTGTCGAGTTT	VU
TTGACTTGTCGGCTCA	VU
TTGACTTGTCGGGTCT	DS9
TTGACTTGTTCCCGAG	DS8
TTGACTTGTTCTCATT	DS6
TTGACTTTCAAGCCTA	VU
TTGACTTTCGAACGGA	DS8
TTGACTTTCGTATCAG	DS3
TTGACTTTCTGAGTGT	DS6
TTGCCGTAGGGCTCTC	DS7
TTGCCGTAGTTTAGGA	DS6
TTGCCGTCACACCGCA	DS9
TTGCCGTCACCACGTG	DS6
TTGCCGTCAGAAGCAC	DS8
TTGCCGTCATGCGCAC	VU
TTGCCGTGTCCAACTA	VU
TTGCCGTGTCGCTTCT	DS8
TTGCCGTGTCTCTCGT	DS6
TTGCCGTGTTTAAGCC	DS6
TTGCCGTTCAGCTTAG	DS8
TTGCCGTTCATTGCCC	DS9
TTGCCGTTCGAGCCCA	DS9
TTGCCGTTCTTTACAC	DS3
TTGCGTCAGAAGGGTA	DS8
TTGCGTCAGGAGCGAG	DS9
TTGCGTCAGTACATGA	DS9
TTGCGTCCAGCTTCGG	DS6
TTGCGTCCAGGCTCAC	DS9
TTGCGTCCAGTTAACC	DS6
TTGCGTCCATGCATGT	DS7
TTGCGTCGTCTGCCAG	VU
TTGCGTCTCAAACCAC	DS8
TTGCGTCTCAATCTCT	DS3
TTGCGTCTCGAGAGCA	DS3
TTGGAACAGAATTGTG	DS3
TTGGAACCAGCTGGCT	DS8
TTGGAACTCAGTCAGT	VU
TTGGAACTCCTATTCA	DS8
TTGGAACTCCTTGACC	DS3
TTGGCAAAGATCGGGT	DS7
TTGGCAAAGGGCATGT	DS9
TTGGCAAAGGGTTCCC	DS3
TTGGCAAAGTGTTTGC	VU
TTGGCAACAAGGACAC	DS7
TTGGCAATCTAGAGTC	VU
TTGTAGGAGCCACGTC	DS6
TTGTAGGAGTGTTGAA	DS6
TTGTAGGAGTTCGATC	DS8
TTGTAGGCAATGCCAT	DS7
TTGTAGGCACGTCAGC	DS7
TTGTAGGGTAGAAAGG	DS3
TTGTAGGTCACAATGC	VU
TTGTAGGTCAGTTGAC	VU
TTGTAGGTCCTTGACC	DS8
TTGTAGGTCGCCTGAG	DS8
TTGTAGGTCTTCGAGA	DS8
TTTACTGAGAAGCCCA	DS9
TTTACTGAGATGGCGT	DS7
TTTACTGAGTGTACTC	DS9
TTTACTGCAAACGTGG	DS7
TTTACTGCACAGACAG	DS7
TTTACTGGTAGTAGTA	DS7
TTTACTGGTCGCTTCT	DS6
TTTACTGGTGACTACT	DS7
TTTACTGGTGTTTGTG	DS6
TTTACTGTCAGTGCAT	DS9
TTTACTGTCATCACCC	DS7
TTTATGCAGAGTAAGG	DS3
TTTATGCAGCGGATCA	DS9
TTTATGCAGGTGCAAC	DS8
TTTATGCAGTGTTAGA	DS6
TTTATGCCAATAGCGG	VU
TTTATGCCAATCCAAC	DS8
TTTATGCCACCGAATT	DS6
TTTATGCCACGACGAA	DS6
TTTATGCCACGGTAAG	DS9
TTTATGCCATGGGACA	DS8
TTTATGCGTGAGTGAC	DS6
TTTATGCGTGTAACGG	VU
TTTATGCGTGTGAAAT	DS6
TTTATGCGTTCAGACT	DS6
TTTATGCGTTGCGTTA	DS3
TTTATGCTCACAACGT	DS8
TTTATGCTCACGCATA	DS9
TTTATGCTCACTCTTA	DS6
TTTATGCTCCTTGACC	DS3
TTTATGCTCTGTCTCG	DS3
TTTCCTCAGACCGGAT	DS8
TTTCCTCAGACGCAAC	DS6
TTTCCTCAGCCACGTC	DS6
TTTCCTCAGCGTAGTG	DS6
TTTCCTCAGGACACCA	DS7
TTTCCTCAGTGGTAGC	DS6
TTTCCTCCAATCGAAA	DS8
TTTCCTCCAGCCTTTC	DS6
TTTCCTCCAGGCAGTA	DS9
TTTCCTCCAGTGGAGT	DS6
TTTCCTCGTAGCTTGT	VU
TTTCCTCGTCTAGTCA	DS7
TTTCCTCGTGACGCCT	DS6
TTTCCTCGTGATAAAC	DS8
TTTCCTCGTTCTGGTA	DS9
TTTCCTCGTTGATTGC	VU
TTTCCTCTCACGACTA	VU
TTTCCTCTCGCAAGCC	DS8
TTTCCTCTCTATGTGG	DS9
TTTCCTCTCTGCGGCA	DS6
TTTGCGCAGATGAGAG	DS6
TTTGCGCCATAGAAAC	DS6
TTTGCGCCATCGATTG	DS7
TTTGCGCGTCTTGTCC	VU
TTTGCGCGTGTGTGCC	DS8
TTTGCGCGTTCCACAA	DS8
TTTGCGCGTTCTCATT	DS8
TTTGCGCGTTGTACAC	DS7
TTTGCGCTCAGTTCGA	DS8
TTTGCGCTCCGCATAA	DS7
TTTGCGCTCCTTTCGG	DS9
TTTGCGCTCTTCGGTC	DS8
TTTGGTTAGCGCCTCA	DS6
TTTGGTTAGGGCATGT	VU
TTTGGTTCAAGAGTCG	DS9
TTTGGTTGTAGAGCTG	DS9
TTTGGTTTCCACTGGG	DS7
TTTGGTTTCTTGAGAC	DS6
TTTGTCAAGACTTTCG	DS8
TTTGTCAAGTGTACTC	DS3
TTTGTCACACCAGATT	DS8
TTTGTCAGTACAGCAG	DS8
TTTGTCAGTCTCTTAT	DS6
TTTGTCAGTTAAGTAG	VU
