AAACCTGAGACAAGCC	MGH
AAACCTGAGGACATTA	BR1
AAACCTGAGGGATGGG	MGH
AAACCTGCAATCTGCA	BR1
AAACCTGCACACAGAG	BR1
AAACCTGCACCACCAG	MGH
AAACCTGGTAGGGACT	MGH
AAACCTGGTCAGAATA	BR1
AAACCTGGTCGCGAAA	BR1
AAACCTGGTCTACCTC	VU
AAACCTGGTTCCACGG	BR1
AAACGGGAGACAATAC	BR1
AAACGGGAGGATGGAA	BR1
AAACGGGAGTGGTAAT	BR1
AAACGGGCATGCATGT	BR1
AAAGATGAGCTAAACA	VU
AAAGATGAGGGAACGG	BR1
AAAGATGAGTATTGGA	VU
AAAGATGAGTGCAAGC	MGH
AAAGATGCACCCATGG	BR1
AAAGATGCAGGGTATG	BR1
AAAGATGCATAAGACA	VU
AAAGATGCATCCAACA	BR1
AAAGATGGTAGCACGA	BR1
AAAGATGGTGCACCAC	MGH
AAAGATGGTGCTCTTC	BR1
AAAGATGGTTCAGGCC	MGH
AAAGATGTCAAAGTAG	BR1
AAAGATGTCCCAAGAT	BR1
AAAGCAACACCGGAAA	BR1
AAAGCAACAGAGTGTG	MGH
AAAGCAACATACTCTT	MGH
AAAGCAACATCAGTCA	MGH
AAAGCAAGTCGGGTCT	BR1
AAAGCAATCGTAGGAG	MGH
AAAGTAGAGATCCCGC	BR1
AAAGTAGAGGTGGGTT	VU
AAAGTAGCACATCCAA	BR1
AAAGTAGGTCAAAGCG	VU
AAAGTAGGTCGCTTCT	MGH
AAAGTAGGTCTGATTG	BR1
AAAGTAGGTTTGTGTG	MGH
AAAGTAGTCTCGTTTA	MGH
AAATGCCCAACTGCTA	BR1
AAATGCCTCACTCTTA	BR1
AACACGTAGCCGGTAA	VU
AACACGTCAAGGCTCC	MGH
AACACGTCACTCTGTC	BR1
AACACGTCAGGCTCAC	BR1
AACACGTGTGTCCTCT	BR1
AACACGTTCCGCATAA	MGH
AACCATGAGACACGAC	BR1
AACCATGAGTGTTAGA	MGH
AACCATGCACCACCAG	VU
AACCATGCACTCAGGC	MGH
AACCATGCAGCGTTCG	MGH
AACCATGCAGGCTCAC	VU
AACCATGTCCCATTTA	VU
AACCATGTCTAACTTC	VU
AACCGCGAGTCAATAG	MGH
AACCGCGAGTGGACGT	BR1
AACCGCGCAAGAAGAG	MGH
AACCGCGCACAAGTAA	BR1
AACCGCGCACACCGCA	MGH
AACCGCGCAGGACCCT	VU
AACCGCGCATCGATTG	BR1
AACCGCGCATTGGGCC	BR1
AACCGCGGTACCAGTT	BR1
AACCGCGGTCCGAATT	MGH
AACCGCGGTGCAACTT	BR1
AACCGCGGTTAAGAAC	MGH
AACCGCGTCACTTCAT	MGH
AACCGCGTCCGTCAAA	MGH
AACCGCGTCCGTTGCT	VU
AACCGCGTCTCAAGTG	BR1
AACCGCGTCTTTACGT	VU
AACGTTGAGATGTGTA	MGH
AACGTTGCATCTACGA	BR1
AACGTTGGTGAGCGAT	BR1
AACGTTGGTTCAACCA	MGH
AACGTTGTCCTTTACA	BR1
AACGTTGTCGAGAACG	MGH
AACGTTGTCGGATGTT	VU
AACTCAGCAACTTGAC	VU
AACTCAGCACATTTCT	MGH
AACTCAGCATCGGACC	VU
AACTCAGCATCGTCGG	VU
AACTCAGCATTCTCAT	VU
AACTCAGGTCAAAGCG	BR1
AACTCAGTCCGAATGT	BR1
AACTCAGTCGCGATCG	BR1
AACTCAGTCGCGGATC	VU
AACTCCCAGAAGAAGC	BR1
AACTCCCAGAGTGACC	BR1
AACTCCCAGCGAGAAA	BR1
AACTCCCCAATGAATG	VU
AACTCCCCACCAGTTA	BR1
AACTCCCCAGCCTTTC	MGH
AACTCCCCATACAGCT	VU
AACTCCCCATCCTTGC	MGH
AACTCCCGTTCAGGCC	MGH
AACTCCCGTTGACGTT	BR1
AACTCTTAGGAATCGC	BR1
AACTCTTCACCTATCC	BR1
AACTCTTCACGGTAGA	BR1
AACTCTTCATGCCTAA	MGH
AACTCTTGTAGAGCTG	BR1
AACTCTTGTGCACCAC	BR1
AACTGGTAGGCGATAC	MGH
AACTGGTCAAGACGTG	BR1
AACTGGTCACATCTTT	VU
AACTGGTCATATGGTC	MGH
AACTGGTGTACCAGTT	MGH
AACTGGTGTAGCGTCC	MGH
AACTGGTGTTACGACT	VU
AACTTTCAGGTGCACA	MGH
AACTTTCAGTGAATTG	BR1
AACTTTCAGTTCGCGC	BR1
AACTTTCGTACCGCTG	MGH
AACTTTCTCACGATGT	MGH
AACTTTCTCGACCAGC	VU
AACTTTCTCGCATGGC	BR1
AACTTTCTCGGAAACG	MGH
AAGACCTAGAGACTTA	BR1
AAGACCTAGCTGGAAC	VU
AAGACCTAGTGTTAGA	BR1
AAGACCTCAGTCTTCC	VU
AAGACCTCATGGTAGG	BR1
AAGACCTGTCCAGTTA	BR1
AAGACCTGTCCTGCTT	VU
AAGACCTTCTGTCTCG	BR1
AAGCCGCAGCGCCTTG	MGH
AAGCCGCAGGAATTAC	BR1
AAGCCGCAGTTGAGTA	VU
AAGCCGCCATGATCCA	BR1
AAGCCGCCATTCACTT	VU
AAGCCGCGTATTACCG	BR1
AAGCCGCGTTGGACCC	VU
AAGCCGCTCCAGAGGA	BR1
AAGGAGCCAACGATCT	BR1
AAGGAGCCAATCACAC	BR1
AAGGAGCCAGTTCCCT	MGH
AAGGAGCGTCTAGCCG	VU
AAGGAGCTCGTAGATC	VU
AAGGAGCTCGTCTGAA	BR1
AAGGCAGAGTCGTACT	MGH
AAGGCAGCACGTGAGA	BR1
AAGGCAGGTCAAGCGA	MGH
AAGGCAGTCCCTCTTT	MGH
AAGGTTCCAAAGGAAG	BR1
AAGGTTCGTTGCTCCT	MGH
AAGGTTCTCAAACAAG	BR1
AAGGTTCTCATTATCC	BR1
AAGGTTCTCGCGTTTC	VU
AAGTCTGGTAGCGTGA	BR1
AATCCAGAGCAATATG	BR1
AATCCAGAGCGTGAGT	MGH
AATCCAGCACAACGTT	VU
AATCCAGCATCGATGT	MGH
AATCCAGGTAGCAAAT	VU
AATCCAGTCAGCTCGG	BR1
AATCCAGTCATTTGGG	MGH
AATCGGTAGGACGAAA	VU
AATCGGTAGTAGCGGT	BR1
AATCGGTCAGCCTGTG	MGH
AATCGGTGTACCGAGA	BR1
AATCGGTGTCGCGAAA	MGH
AATCGGTGTGGCAAAC	BR1
AATCGGTGTTGGTTTG	BR1
ACACCAAAGGCAAAGA	BR1
ACACCAAAGGCCCGTT	BR1
ACACCAAGTAGGCTGA	VU
ACACCAATCAAACCAC	MGH
ACACCAATCACGAAGG	VU
ACACCAATCACTTACT	BR1
ACACCAATCACTTATC	MGH
ACACCAATCAGCTGGC	BR1
ACACCAATCCGTACAA	BR1
ACACCAATCGTCTGCT	MGH
ACACCAATCTTCGAGA	BR1
ACACCCTAGACCGGAT	MGH
ACACCCTCAAATCCGT	VU
ACACCCTCACGTCAGC	VU
ACACCCTCATCTACGA	BR1
ACACCCTGTCATCGGC	BR1
ACACCCTGTTTCGCTC	BR1
ACACCCTTCACCAGGC	BR1
ACACCCTTCAGTGCAT	BR1
ACACCCTTCGAGAGCA	BR1
ACACCGGAGCGCTCCA	MGH
ACACCGGAGCTCAACT	BR1
ACACCGGCAAGGTTCT	BR1
ACACCGGCAGGTCCAC	BR1
ACACCGGGTCCAGTGC	BR1
ACACTGAAGGGATCTG	MGH
ACACTGAAGTGACATA	BR1
ACACTGACAAACCTAC	MGH
ACACTGACAGGGTACA	VU
ACACTGAGTACGCTGC	BR1
ACACTGAGTGTGGTTT	MGH
ACACTGATCGCCTGTT	MGH
ACACTGATCGGTTAAC	BR1
ACACTGATCGTCTGCT	MGH
ACACTGATCTGCAGTA	MGH
ACAGCCGAGCCCAACC	BR1
ACAGCCGAGGAACTGC	VU
ACAGCCGAGGAGTCTG	MGH
ACAGCCGCAAGTAGTA	VU
ACAGCCGCACGGTGTC	MGH
ACAGCCGGTTTGCATG	BR1
ACAGCCGTCTGCCCTA	MGH
ACAGCTAAGCCTATGT	BR1
ACAGCTACAGCTGTTA	MGH
ACAGCTAGTAGCTCCG	BR1
ACAGCTAGTAGCTTGT	BR1
ACAGCTAGTCGAATCT	BR1
ACAGCTAGTTGAGGTG	BR1
ACAGCTATCAGAGACG	MGH
ACAGCTATCTCACATT	BR1
ACATACGAGGCAAAGA	MGH
ACATACGCAGATCGGA	MGH
ACATACGCATATGAGA	BR1
ACATACGGTAGCCTCG	MGH
ACATACGGTCCGCTGA	BR1
ACATACGTCATAACCG	MGH
ACATACGTCCAAACTG	MGH
ACATACGTCCGCTGTT	MGH
ACATACGTCTATCCTA	BR1
ACATCAGAGATGGCGT	BR1
ACATCAGAGGCTATCT	MGH
ACATCAGCAATGGTCT	MGH
ACATCAGCACTCTGTC	MGH
ACATCAGGTCATGCAT	BR1
ACATCAGGTGACGGTA	BR1
ACATCAGGTTACAGAA	MGH
ACATGGTAGGAGTTGC	BR1
ACATGGTAGGGCTTGA	MGH
ACATGGTCAAGTCATC	MGH
ACATGGTCACAACTGT	VU
ACATGGTCAGGGATTG	MGH
ACATGGTCATAGTAAG	MGH
ACATGGTGTCGAATCT	MGH
ACATGGTGTCGCCATG	MGH
ACATGGTGTTCTGTTT	BR1
ACATGGTTCAAAGACA	MGH
ACATGGTTCAACGGGA	BR1
ACCAGTAAGCCACTAT	BR1
ACCAGTACACATAACC	MGH
ACCAGTAGTATATGAG	BR1
ACCAGTAGTGCTGTAT	MGH
ACCAGTAGTTTGTTGG	BR1
ACCAGTATCACATACG	MGH
ACCCACTAGCCCAATT	MGH
ACCCACTCAAGCCTAT	BR1
ACCCACTCACGAAACG	MGH
ACCCACTCAGTCGATT	MGH
ACCCACTGTACTTAGC	VU
ACCCACTGTATTCTCT	BR1
ACCCACTGTCTTCAAG	MGH
ACCCACTTCAGTTCGA	MGH
ACCCACTTCGAATGGG	BR1
ACCCACTTCGAGAACG	BR1
ACCGTAAAGTCAAGCG	BR1
ACCGTAACAGACAAAT	MGH
ACCGTAACAGATCTGT	VU
ACCGTAAGTCAACTGT	VU
ACCGTAAGTTTCCACC	BR1
ACCGTAATCAATAAGG	BR1
ACCGTAATCACCGTAA	VU
ACCGTAATCACCTCGT	BR1
ACCTTTACACGAAATA	VU
ACCTTTACACGACTCG	MGH
ACCTTTACAGTGGAGT	BR1
ACCTTTAGTAAGTTCC	MGH
ACCTTTAGTATAGGTA	BR1
ACCTTTAGTCCAGTTA	BR1
ACCTTTAGTCGAAAGC	BR1
ACCTTTAGTTCAACCA	VU
ACGAGCCAGGCATTGG	VU
ACGAGCCCACATGACT	MGH
ACGAGCCGTACAGACG	MGH
ACGAGCCGTCATGCAT	BR1
ACGAGCCGTCTCAACA	BR1
ACGAGCCTCCTTTCTC	VU
ACGAGGAAGCGGATCA	BR1
ACGAGGAAGTCTCCTC	BR1
ACGAGGACATCGGACC	BR1
ACGAGGAGTCCGAATT	BR1
ACGAGGAGTCCTGCTT	BR1
ACGATACAGATGAGAG	MGH
ACGATACCACTGTGTA	MGH
ACGATACGTCTCATCC	MGH
ACGATGTAGGCTCAGA	VU
ACGATGTAGGGCACTA	BR1
ACGATGTAGTTACCCA	BR1
ACGATGTCATATACCG	BR1
ACGATGTGTAGCCTCG	MGH
ACGATGTGTCTAGCCG	MGH
ACGATGTTCCAAATGC	MGH
ACGATGTTCGTACGGC	BR1
ACGCAGCCAAGACACG	BR1
ACGCAGCCATTCTCAT	BR1
ACGCAGCTCACCAGGC	VU
ACGCCAGAGAGACTTA	MGH
ACGCCAGAGAGGTACC	BR1
ACGCCAGCACAAGACG	MGH
ACGCCAGCACAGAGGT	MGH
ACGCCAGGTCGGCTCA	BR1
ACGCCAGGTCTCACCT	BR1
ACGCCAGTCAACACGT	MGH
ACGCCAGTCCGTTGTC	VU
ACGCCAGTCGATCCCT	BR1
ACGCCAGTCTGCCCTA	MGH
ACGCCGAAGACGACGT	MGH
ACGCCGAAGCGAAGGG	MGH
ACGCCGACACCTCGGA	BR1
ACGCCGACAGTCGTGC	MGH
ACGCCGACATGCCCGA	MGH
ACGCCGAGTTCTGTTT	MGH
ACGCCGATCCCTCAGT	BR1
ACGGAGAAGATGCCTT	VU
ACGGAGACAAGCGTAG	VU
ACGGAGACAAGTTGTC	BR1
ACGGAGACACCACCAG	BR1
ACGGCCAAGCCGCCTA	MGH
ACGGCCAAGGCCGAAT	BR1
ACGGCCAAGGGAACGG	BR1
ACGGCCAAGTTGTAGA	BR1
ACGGCCACAACTGGCC	BR1
ACGGCCACACTTAACG	MGH
ACGGCCACATCGTCGG	MGH
ACGGCCATCAGAGGTG	MGH
ACGGCCATCATGCAAC	BR1
ACGGCCATCTGCGACG	VU
ACGGGCTCAGGAATGC	VU
ACGGGCTGTGTCGCTG	MGH
ACGGGCTGTTAGATGA	BR1
ACGGGCTTCACTTACT	BR1
ACGGGCTTCAGGCAAG	MGH
ACGGGCTTCCACTGGG	VU
ACGGGTCAGCTGGAAC	VU
ACGGGTCAGTTCGCAT	BR1
ACGGGTCCATTCGACA	VU
ACGGGTCGTGTTTGTG	BR1
ACGGGTCTCAGTCCCT	VU
ACGGGTCTCGATGAGG	VU
ACGTCAAAGTCTTGCA	BR1
ACGTCAACAGACAAAT	BR1
ACGTCAACAGTAAGAT	MGH
ACGTCAAGTGTTTGTG	BR1
ACGTCAAGTTGTTTGG	MGH
ACGTCAATCAGGTTCA	BR1
ACGTCAATCTCGAGTA	MGH
ACTATCTCAGGGTACA	MGH
ACTATCTCATCCAACA	BR1
ACTATCTGTCTCTTAT	MGH
ACTATCTTCACCGTAA	BR1
ACTATCTTCTAACCGA	BR1
ACTATCTTCTTCATGT	MGH
ACTGAACAGGCAGTCA	BR1
ACTGAACAGTATTGGA	VU
ACTGAACAGTGGAGAA	VU
ACTGAACGTCCGTGAC	BR1
ACTGAACTCAGCGACC	VU
ACTGAGTAGGAATCGC	BR1
ACTGAGTCACTTAACG	MGH
ACTGAGTCATGCGCAC	BR1
ACTGAGTGTAAACGCG	BR1
ACTGAGTGTCAATACC	BR1
ACTGAGTGTTGCCTCT	MGH
ACTGAGTTCAGGTTCA	VU
ACTGAGTTCCGCGGTA	MGH
ACTGATGAGAACAACT	BR1
ACTGATGAGAGTCGGT	BR1
ACTGATGAGATCTGCT	MGH
ACTGATGAGGTTCCTA	MGH
ACTGATGAGTTGAGAT	BR1
ACTGATGCAATAACGA	VU
ACTGATGGTCGGGTCT	VU
ACTGATGGTGCAACGA	BR1
ACTGATGGTTATCCGA	MGH
ACTGATGTCATTGCGA	MGH
ACTGCTCAGACGACGT	BR1
ACTGCTCAGCAGATCG	MGH
ACTGCTCAGCCACTAT	MGH
ACTGCTCCAAGGTTTC	BR1
ACTGCTCGTCAGCTAT	BR1
ACTGCTCGTGCACGAA	VU
ACTGTCCAGTACGTAA	MGH
ACTGTCCCATGGTCAT	BR1
ACTGTCCGTAATAGCA	BR1
ACTGTCCGTCCAACTA	VU
ACTGTCCGTCTGATTG	VU
ACTGTCCTCATTTGGG	BR1
ACTTACTAGACCACGA	BR1
ACTTACTCACCTTGTC	VU
ACTTACTGTGCACCAC	MGH
ACTTACTTCACGCGGT	BR1
ACTTACTTCCCATTAT	VU
ACTTACTTCTGCTGTC	MGH
ACTTACTTCTTGTATC	BR1
ACTTGTTAGATAGGAG	VU
ACTTGTTCAAACCTAC	BR1
ACTTGTTCAGTTAACC	MGH
ACTTGTTGTGTTAAGA	VU
ACTTTCAAGTGTGAAT	MGH
ACTTTCACACGTCAGC	MGH
ACTTTCACAGTAGAGC	BR1
ACTTTCAGTTCGTGAT	BR1
ACTTTCATCCAAGTAC	BR1
AGAATAGAGAAGAAGC	BR1
AGAATAGCACATGACT	MGH
AGAATAGCATTCGACA	BR1
AGAATAGGTAGCGTGA	BR1
AGAATAGTCGTCTGCT	MGH
AGACGTTAGAGCTTCT	MGH
AGACGTTAGCATGGCA	MGH
AGACGTTCAAGACACG	BR1
AGACGTTCACCATGTA	BR1
AGACGTTGTAAGAGAG	MGH
AGACGTTGTTCCCTTG	BR1
AGACGTTTCACTCTTA	VU
AGACGTTTCTTTAGTC	BR1
AGAGCGAAGCACGCCT	VU
AGAGCGAAGTTTCCTT	BR1
AGAGCGACATTCTTAC	BR1
AGAGCGAGTCACCTAA	BR1
AGAGCGAGTCCTCCAT	BR1
AGAGCGATCGGAATCT	MGH
AGAGCGATCTGGTTCC	BR1
AGAGCTTAGGATGCGT	BR1
AGAGCTTAGGGTGTGT	BR1
AGAGCTTAGTTAGGTA	MGH
AGAGCTTCAAGAGTCG	MGH
AGAGCTTCACAGACTT	VU
AGAGCTTGTCAGATAA	MGH
AGAGCTTTCCGTTGCT	VU
AGAGCTTTCGTTACAG	VU
AGAGCTTTCTTGGGTA	MGH
AGAGCTTTCTTGTACT	MGH
AGAGTGGAGACAGAGA	BR1
AGAGTGGAGATCCCGC	MGH
AGAGTGGAGGACAGAA	MGH
AGAGTGGAGGCAGGTT	BR1
AGAGTGGCAACTGGCC	MGH
AGAGTGGCACAACGTT	BR1
AGAGTGGGTAGCTCCG	VU
AGAGTGGGTCCGAAGA	MGH
AGAGTGGTCACCCTCA	BR1
AGAGTGGTCCTGCCAT	MGH
AGATCTGCAAGAGTCG	MGH
AGATCTGCAATCCAAC	MGH
AGATCTGCACCGAATT	BR1
AGATCTGCAGAGTGTG	BR1
AGATCTGGTAAGGATT	BR1
AGATCTGGTAGCTAAA	BR1
AGATCTGGTATAGGGC	MGH
AGATCTGGTGTGACGA	MGH
AGATCTGGTTCGGGCT	MGH
AGATCTGTCCAAATGC	BR1
AGATCTGTCCGCGGTA	MGH
AGATCTGTCTCCCTGA	MGH
AGATTGCAGATGAGAG	MGH
AGATTGCAGGAGTTGC	BR1
AGATTGCAGGCAGTCA	BR1
AGATTGCAGTGCGTGA	BR1
AGATTGCAGTGGAGTC	BR1
AGATTGCCACGTCTCT	BR1
AGATTGCGTCACAAGG	BR1
AGATTGCGTGTTTGGT	MGH
AGATTGCGTTAAGATG	BR1
AGATTGCTCCCTCTTT	VU
AGATTGCTCGACGGAA	BR1
AGATTGCTCTGTGCAA	MGH
AGCAGCCAGCACACAG	MGH
AGCAGCCAGGCTAGGT	BR1
AGCAGCCCAGCGTAAG	MGH
AGCAGCCCAGGGTTAG	VU
AGCATACCAATAACGA	MGH
AGCATACCACGACTCG	BR1
AGCATACTCACAGTAC	MGH
AGCATACTCGCTAGCG	BR1
AGCCTAAAGTACGATA	MGH
AGCCTAAAGTTACCCA	BR1
AGCCTAACAAGCGTAG	VU
AGCCTAACAATAACGA	MGH
AGCCTAACAGATAATG	BR1
AGCCTAACAGGGTATG	BR1
AGCCTAACATGCCACG	VU
AGCCTAACATGGTTGT	MGH
AGCCTAATCGCCTGTT	VU
AGCGGTCAGATCTGAA	BR1
AGCGGTCAGCGTGAAC	MGH
AGCGGTCCAAACGTGG	BR1
AGCGGTCCACGAAACG	BR1
AGCGGTCCACGTCAGC	MGH
AGCGGTCGTAGCGATG	BR1
AGCGGTCGTCCAGTTA	MGH
AGCGGTCTCCACTCCA	BR1
AGCGGTCTCCCTTGTG	MGH
AGCGGTCTCTGCGTAA	BR1
AGCGGTCTCTTCCTTC	MGH
AGCGTATAGACTCGGA	BR1
AGCGTATAGTACGCCC	BR1
AGCGTATCAAGAGTCG	MGH
AGCGTATCACGGTAGA	BR1
AGCGTATGTCCAAGTT	VU
AGCGTATTCAAAGTAG	BR1
AGCGTATTCCACGCAG	VU
AGCGTATTCCCTAATT	BR1
AGCGTATTCGCGATCG	BR1
AGCGTCGAGCCCAGCT	VU
AGCGTCGTCACTATTC	VU
AGCTCCTAGAAACGAG	BR1
AGCTCCTAGTGAACAT	MGH
AGCTCCTCACATCCAA	VU
AGCTCCTGTAGGCTGA	BR1
AGCTCCTGTGCAACGA	MGH
AGCTCTCAGATATGGT	BR1
AGCTCTCAGCGTAGTG	MGH
AGCTCTCGTTACCGAT	MGH
AGCTCTCTCAACACCA	MGH
AGCTCTCTCAGAGGTG	MGH
AGCTCTCTCGGCTACG	MGH
AGCTTGAAGAGCAATT	BR1
AGCTTGAAGCTCAACT	VU
AGCTTGACACATGTGT	MGH
AGCTTGACATGCAATC	MGH
AGCTTGAGTCTGCAAT	BR1
AGCTTGAGTGAGCGAT	MGH
AGCTTGAGTTCGTTGA	BR1
AGCTTGATCAATCACG	MGH
AGCTTGATCTCCAACC	BR1
AGGCCACAGAAGGACA	BR1
AGGCCACAGTAGATGT	BR1
AGGCCACAGTTGTCGT	VU
AGGCCACCAAAGGTGC	MGH
AGGCCACCACAAGTAA	BR1
AGGCCACCACCTGGTG	BR1
AGGCCACGTCCAGTAT	MGH
AGGCCACGTCTTCGTC	BR1
AGGCCACTCAACCAAC	VU
AGGCCGTGTACAGTTC	MGH
AGGCCGTGTCTAGTCA	MGH
AGGCCGTTCAAGGTAA	BR1
AGGCCGTTCCATGCTC	BR1
AGGGAGTAGCTGTTCA	MGH
AGGGAGTCATGGTTGT	BR1
AGGGAGTGTGGTCCGT	MGH
AGGGAGTGTTTAGCTG	MGH
AGGGAGTTCTGAGTGT	BR1
AGGGATGAGAGCTGGT	BR1
AGGGATGAGGACACCA	MGH
AGGGATGAGGGTGTGT	BR1
AGGGATGCAAAGAATC	VU
AGGGATGCACAAGCCC	MGH
AGGGATGCATTCTTAC	BR1
AGGGATGCATTTCACT	BR1
AGGGATGTCGTGACAT	MGH
AGGGTGAAGCCACGCT	MGH
AGGGTGAAGGGTTTCT	BR1
AGGGTGAAGGTAGCCA	BR1
AGGGTGACAAATTGCC	BR1
AGGGTGACATGCCCGA	VU
AGGGTGAGTCACTGGC	BR1
AGGGTGAGTCACTTCC	BR1
AGGGTGATCAGTCAGT	MGH
AGGGTGATCGCGCCAA	BR1
AGGTCATAGAACAACT	MGH
AGGTCATCAAGTAATG	VU
AGGTCATCAATGACCT	MGH
AGGTCATCAATGGACG	MGH
AGGTCATCACTGTGTA	VU
AGGTCATCAGATCCAT	BR1
AGGTCATCATCACCCT	MGH
AGGTCATGTCCAGTAT	MGH
AGGTCATGTCTGCAAT	BR1
AGGTCATTCTTACCGC	BR1
AGGTCCGAGACTAAGT	MGH
AGGTCCGAGAGTGAGA	MGH
AGGTCCGAGGCCGAAT	VU
AGGTCCGCAGTTCATG	BR1
AGGTCCGGTAAATGTG	BR1
AGGTCCGGTAGCTAAA	VU
AGGTCCGGTATAGGTA	MGH
AGGTCCGGTATGAAAC	BR1
AGGTCCGGTCAATGTC	BR1
AGGTCCGGTGGGTATG	VU
AGGTCCGTCCAAACTG	MGH
AGGTCCGTCTACTCAT	BR1
AGTAGTCAGCGATATA	VU
AGTAGTCCACCGAAAG	BR1
AGTAGTCGTATAGTAG	BR1
AGTAGTCGTCCCTTGT	BR1
AGTAGTCGTCCGAGTC	BR1
AGTAGTCGTGAGGGAG	BR1
AGTAGTCTCAGTACGT	MGH
AGTAGTCTCATGCTCC	BR1
AGTAGTCTCCACGTGG	MGH
AGTAGTCTCGCTAGCG	BR1
AGTAGTCTCTTCGAGA	MGH
AGTCTTTCATACAGCT	BR1
AGTCTTTGTCTCTTAT	BR1
AGTCTTTTCCAAACAC	MGH
AGTCTTTTCGTTGCCT	BR1
AGTCTTTTCTAACGGT	VU
AGTGAGGAGGTCATCT	VU
AGTGAGGCAATGAAAC	BR1
AGTGAGGTCAATAAGG	BR1
AGTGGGAAGAGCCTAG	MGH
AGTGGGAAGAGGTAGA	MGH
AGTGGGACATGCCACG	MGH
AGTGGGAGTTCCACGG	BR1
AGTGGGATCAAACGGG	BR1
AGTGGGATCTATCCCG	VU
AGTGTCAAGAAACGCC	MGH
AGTGTCAAGAGCCCAA	BR1
AGTGTCAAGATAGTCA	VU
AGTGTCAAGCGTCAAG	BR1
AGTGTCACACGAAAGC	VU
AGTGTCAGTACCGCTG	BR1
AGTGTCATCGACCAGC	VU
AGTGTCATCGTGGTCG	BR1
AGTGTCATCGTTACGA	BR1
AGTTGGTAGCCAGTTT	BR1
AGTTGGTAGTAGATGT	BR1
AGTTGGTCAAAGGCGT	MGH
AGTTGGTGTAATCGTC	MGH
AGTTGGTGTACGCACC	MGH
AGTTGGTGTCAATACC	BR1
ATAACGCAGCGGATCA	MGH
ATAACGCGTACCTACA	BR1
ATAACGCGTCGAACAG	BR1
ATAACGCTCGTCTGCT	MGH
ATAACGCTCTGAAAGA	BR1
ATAAGAGAGTACCGGA	BR1
ATAAGAGCAATGCCAT	MGH
ATAAGAGCAATTCCTT	MGH
ATAAGAGGTGTGCCTG	BR1
ATAGACCAGCGTGAAC	MGH
ATAGACCCATACTCTT	MGH
ATAGACCGTTCAGACT	BR1
ATAGACCGTTGTGGAG	BR1
ATAGACCTCTACGAGT	MGH
ATCACGAAGCGATTCT	BR1
ATCACGAGTCTGCAAT	VU
ATCATCTTCAGGATCT	MGH
ATCATGGCAGATCTGT	BR1
ATCATGGTCCTATGTT	BR1
ATCCACCCAAGGACAC	MGH
ATCCACCGTCAAGCGA	MGH
ATCCACCGTGCACTTA	VU
ATCCACCGTTCCCGAG	MGH
ATCCACCGTTGTGGAG	MGH
ATCCACCTCGCGATCG	MGH
ATCCGAAAGCTTATCG	BR1
ATCCGAAAGTCCATAC	MGH
ATCCGAATCACCTCGT	BR1
ATCCGAATCAGGCCCA	MGH
ATCCGAATCTTGTTTG	BR1
ATCGAGTAGGCTCATT	BR1
ATCGAGTCAATGTAAG	BR1
ATCGAGTCACGTCAGC	BR1
ATCGAGTGTAGCGTGA	MGH
ATCGAGTTCTCGTTTA	BR1
ATCTACTAGATGTCGG	VU
ATCTACTAGCCGTCGT	MGH
ATCTACTAGTGGGCTA	VU
ATCTACTCACAGGAGT	VU
ATCTACTCAGTCAGAG	BR1
ATCTACTGTAAATGTG	MGH
ATCTACTGTGCTAGCC	BR1
ATCTACTTCCAACCAA	BR1
ATCTGCCAGTGAATTG	BR1
ATCTGCCCACAGCCCA	MGH
ATCTGCCCATAGAAAC	MGH
ATCTGCCGTAAACCTC	BR1
ATCTGCCGTAAGTGGC	MGH
ATCTGCCGTCATATCG	BR1
ATCTGCCGTGCAGACA	BR1
ATCTGCCGTTCTGTTT	BR1
ATGAGGGAGAAGGTGA	MGH
ATGAGGGAGGCATTGG	MGH
ATGAGGGAGTAACCCT	BR1
ATGAGGGCAGCCTTGG	MGH
ATGAGGGCAGGAATCG	VU
ATGAGGGGTAAGTGGC	BR1
ATGAGGGGTATTACCG	BR1
ATGAGGGTCAACCATG	BR1
ATGAGGGTCAGCCTAA	MGH
ATGAGGGTCCCTAACC	MGH
ATGCGATAGCCAGAAC	MGH
ATGCGATAGTAGTGCG	VU
ATGCGATAGTGTTGAA	MGH
ATGCGATAGTTGAGAT	BR1
ATGCGATCAATGGTCT	VU
ATGCGATCACATGTGT	VU
ATGCGATGTCCTAGCG	BR1
ATGCGATGTCGGCACT	BR1
ATGCGATGTTCGCTAA	BR1
ATGCGATTCAGAGACG	VU
ATGCGATTCTGGCGTG	MGH
ATGCGATTCTTTACGT	BR1
ATGGGAGAGCGGATCA	MGH
ATGGGAGCACGTAAGG	BR1
ATGGGAGCAGTAGAGC	VU
ATGGGAGGTCGGCACT	BR1
ATGGGAGGTGAAATCA	VU
ATGGGAGGTGCACGAA	BR1
ATGGGAGGTTAAGGGC	BR1
ATGGGAGGTTAGAACA	MGH
ATGGGAGTCCGTACAA	VU
ATGGGAGTCGGTGTCG	VU
ATGGGAGTCTGATACG	BR1
ATGTGTGAGGTTCCTA	BR1
ATGTGTGCATGGGACA	MGH
ATGTGTGCATTAGGCT	MGH
ATGTGTGGTGCGCTTG	MGH
ATGTGTGTCCTAGGGC	VU
ATTACTCAGACTTGAA	BR1
ATTACTCAGCTGGAAC	BR1
ATTACTCCATACCATG	BR1
ATTACTCGTATCTGCA	BR1
ATTACTCGTCGCGTGT	MGH
ATTACTCGTCTTGATG	MGH
ATTACTCTCCGCATAA	BR1
ATTACTCTCTACTATC	MGH
ATTATCCAGCGGATCA	MGH
ATTATCCCATTGGGCC	VU
ATTATCCGTAGCTAAA	BR1
ATTCTACAGAGACTTA	BR1
ATTCTACAGGCGCTCT	VU
ATTCTACCACGGATAG	BR1
ATTCTACCATTCCTCG	BR1
ATTCTACGTCCGTCAG	BR1
ATTCTACGTGTGAAAT	BR1
ATTCTACGTTCGCGAC	MGH
ATTCTACTCAACGGCC	MGH
ATTCTACTCGTCGTTC	BR1
ATTGGACAGCGATAGC	MGH
ATTGGACTCATCATTC	MGH
ATTGGACTCGTAGATC	BR1
ATTGGACTCGTGGTCG	MGH
ATTGGACTCTCCAGGG	BR1
ATTGGTGAGACTAGGC	MGH
ATTGGTGAGCGTAGTG	BR1
ATTGGTGAGGAGTCTG	VU
ATTGGTGCACGGTGTC	BR1
ATTGGTGGTAGAGGAA	BR1
ATTGGTGTCTGTACGA	MGH
ATTTCTGAGAAGGTTT	VU
ATTTCTGAGTCTCGGC	BR1
ATTTCTGGTAGAAAGG	MGH
ATTTCTGTCATCATTC	BR1
ATTTCTGTCCATGAAC	MGH
ATTTCTGTCTAGAGTC	BR1
CAACCAACACCAACCG	MGH
CAACCAACAGCGAACA	BR1
CAACCAACATAAAGGT	BR1
CAACCAACATAGGATA	MGH
CAACCAACATCCCATC	MGH
CAACCAATCAGAGGTG	MGH
CAACCAATCGCCTGTT	MGH
CAACCAATCTCTTGAT	BR1
CAACCTCAGCGTTGCC	BR1
CAACCTCAGTGAACAT	BR1
CAACCTCCAACGATGG	MGH
CAACCTCCACAGGCCT	BR1
CAACCTCGTAGCGCAA	BR1
CAACCTCGTCTGGTCG	MGH
CAACCTCGTTACGCGC	BR1
CAACTAGCATTCCTGC	BR1
CAACTAGGTCACCCAG	MGH
CAACTAGGTTACTGAC	MGH
CAACTAGGTTCCGTCT	MGH
CAACTAGTCCTACAGA	VU
CAACTAGTCGCATGAT	BR1
CAACTAGTCGTCGTTC	BR1
CAAGAAAAGATCCGAG	MGH
CAAGAAAAGGCCCGTT	VU
CAAGAAAAGTCGCCGT	VU
CAAGAAACACATGTGT	MGH
CAAGAAACAGGTCCAC	BR1
CAAGAAACATCGGGTC	BR1
CAAGAAAGTGCAACTT	MGH
CAAGAAATCGATGAGG	VU
CAAGAAATCGGATGGA	BR1
CAAGATCCAAGTCTGT	BR1
CAAGATCCAATCCAAC	BR1
CAAGATCCAGGTCGTC	BR1
CAAGATCCATTGGTAC	MGH
CAAGATCTCCGCATCT	MGH
CAAGATCTCGGCTTGG	BR1
CAAGATCTCTGATACG	BR1
CAAGGCCAGAGTCGGT	BR1
CAAGGCCAGCATGGCA	BR1
CAAGGCCAGGGCATGT	MGH
CAAGGCCAGTACTTGC	BR1
CAAGGCCAGTAGGCCA	MGH
CAAGGCCAGTGGAGTC	VU
CAAGGCCCAATCTACG	VU
CAAGGCCCATGTCCTC	MGH
CAAGGCCCATTCTTAC	MGH
CAAGGCCGTCGGCATC	BR1
CAAGGCCTCACGGTTA	BR1
CAAGGCCTCGCCCTTA	MGH
CAAGTTGAGTATCTCG	MGH
CAAGTTGCAACGCACC	MGH
CAAGTTGGTAGAAGGA	BR1
CAAGTTGGTGATGCCC	MGH
CACAAACAGCCTTGAT	BR1
CACAAACAGTGTTGAA	BR1
CACAAACCAAGACACG	MGH
CACAAACCATACGCCG	MGH
CACAAACCATCCGCGA	BR1
CACAAACGTAGAGGAA	VU
CACAAACGTCGACTAT	MGH
CACAAACGTCTCACCT	MGH
CACAAACGTGCTAGCC	BR1
CACAAACGTTACGGAG	BR1
CACAAACTCAAGCCTA	MGH
CACAAACTCAGTGTTG	BR1
CACAAACTCCTAAGTG	BR1
CACAAACTCCTCCTAG	MGH
CACACAAAGCGTTTAC	MGH
CACACAAAGGCTACGA	MGH
CACACAAAGTTGTAGA	VU
CACACAACAATTCCTT	BR1
CACACAACACATTAGC	MGH
CACACAAGTAGCGTGA	BR1
CACACAATCAGTGTTG	MGH
CACACAATCGTATCAG	BR1
CACACCTAGCCGCCTA	BR1
CACACCTGTCCGAGTC	MGH
CACACCTTCACATACG	BR1
CACACCTTCTCTGCTG	VU
CACACTCAGTACCGGA	VU
CACACTCAGTCGTTTG	BR1
CACACTCGTGCTAGCC	BR1
CACACTCGTGTTTGTG	MGH
CACACTCGTTCATGGT	BR1
CACAGGCAGACGCACA	BR1
CACAGGCAGAGTACCG	MGH
CACAGGCAGGCAAAGA	BR1
CACAGGCCACAAGCCC	BR1
CACAGGCGTTGCGCAC	MGH
CACAGGCTCCTAAGTG	MGH
CACAGGCTCCTTAATC	BR1
CACAGGCTCTCTGCTG	MGH
CACAGTAAGGTAGCCA	MGH
CACAGTACAAGGTTTC	VU
CACAGTACAATAACGA	VU
CACAGTACACGGACAA	MGH
CACAGTACATGACATC	BR1
CACAGTACATTGGTAC	MGH
CACAGTAGTCTCATCC	VU
CACAGTAGTGGTTTCA	BR1
CACAGTATCAAGGTAA	VU
CACAGTATCAGCTCGG	MGH
CACAGTATCTCAAGTG	VU
CACAGTATCTGATTCT	MGH
CACATAGAGACCTTTG	BR1
CACATAGCAAGGACTG	MGH
CACATAGGTCTGCAAT	BR1
CACATAGGTCTTTCAT	BR1
CACATAGGTGAGCGAT	BR1
CACATAGGTGAGGGAG	BR1
CACATAGGTTCTGGTA	VU
CACATTTAGCGAGAAA	MGH
CACATTTAGGTAGCCA	MGH
CACATTTAGGTCGGAT	BR1
CACATTTAGTGTACCT	MGH
CACATTTCACGGTGTC	VU
CACATTTGTTAGTGGG	VU
CACCACTAGCAAATCA	BR1
CACCACTCACATAACC	MGH
CACCACTCACCAGATT	MGH
CACCACTGTAAATGAC	BR1
CACCACTGTAGCGTAG	BR1
CACCACTGTCTAGAGG	BR1
CACCACTGTGAGTATA	BR1
CACCAGGAGAACAACT	BR1
CACCAGGGTCTGATCA	MGH
CACCAGGGTCTGATTG	BR1
CACCAGGTCCTCATTA	BR1
CACCTTGAGCGTTTAC	MGH
CACCTTGAGGGAGTAA	MGH
CACCTTGAGTGAAGAG	MGH
CACCTTGCAGATCTGT	MGH
CACTCCAAGGCGTACA	MGH
CACTCCACAAACCTAC	BR1
CACTCCAGTCACCCAG	BR1
CACTCCAGTGACGCCT	BR1
CACTCCATCAAACCAC	MGH
CAGAATCAGGAACTGC	MGH
CAGAATCCATTACCTT	MGH
CAGAATCGTCGCGTGT	VU
CAGAATCTCTCCAACC	MGH
CAGAGAGAGGCCCGTT	VU
CAGAGAGGTAGCTTGT	BR1
CAGAGAGTCAAACAAG	BR1
CAGATCAAGTCTCGGC	MGH
CAGATCAGTCCGTGAC	VU
CAGATCATCTCTTATG	BR1
CAGCAGCAGCCCAACC	MGH
CAGCAGCAGGGTCGAT	MGH
CAGCAGCCAGACGCTC	MGH
CAGCAGCCAGCGTAAG	BR1
CAGCAGCCAGCTTAAC	BR1
CAGCAGCGTGTCAATC	VU
CAGCATAGTGGAAAGA	MGH
CAGCATATCAGGCCCA	BR1
CAGCATATCGCCGTGA	MGH
CAGCCGAAGTGTCCAT	MGH
CAGCCGAAGTTTCCTT	VU
CAGCCGACACGCTTTC	MGH
CAGCCGACATCACGAT	MGH
CAGCCGACATCGGACC	BR1
CAGCCGAGTCTGCCAG	VU
CAGCCGATCAACGGGA	VU
CAGCCGATCACTCCTG	BR1
CAGCCGATCCCTGACT	MGH
CAGCCGATCCGTCAAA	BR1
CAGCCGATCCTGCAGG	VU
CAGCGACAGGAACTGC	BR1
CAGCGACCAATACGCT	BR1
CAGCGACCAATGTAAG	MGH
CAGCGACCAGTACACT	BR1
CAGCGACCATGGAATA	MGH
CAGCGACGTCAGCTAT	VU
CAGCGACGTGATGTCT	BR1
CAGCGACGTGGTCCGT	MGH
CAGCGACGTTCAACCA	BR1
CAGCGACGTTTACTCT	MGH
CAGCGACTCAATAAGG	MGH
CAGCGACTCCTCAACC	BR1
CAGCGACTCTGATACG	BR1
CAGCGACTCTTCGAGA	BR1
CAGCTAAAGTGTTAGA	BR1
CAGCTAACAGATGGCA	BR1
CAGCTAACATGCCCGA	VU
CAGCTAATCGAGGTAG	BR1
CAGCTAATCGTAGGTT	VU
CAGCTAATCTGGGCCA	MGH
CAGCTGGAGCAACGGT	VU
CAGCTGGCAGGACGTA	BR1
CAGCTGGCATCCGCGA	MGH
CAGCTGGGTACGCTGC	BR1
CAGCTGGGTTCCACAA	BR1
CAGCTGGTCGGACAAG	MGH
CAGGTGCAGCCCAACC	BR1
CAGGTGCAGCCCAGCT	VU
CAGGTGCAGGGTGTGT	VU
CAGGTGCCAAACGCGA	MGH
CAGGTGCCAAGAAGAG	MGH
CAGGTGCCACGAAATA	BR1
CAGGTGCCATAAAGGT	BR1
CAGGTGCCATGTTGAC	MGH
CAGGTGCGTGCAGTAG	VU
CAGGTGCGTGGAAAGA	BR1
CAGGTGCGTTCAGGCC	BR1
CAGGTGCTCAAGATCC	MGH
CAGTAACAGCCTTGAT	MGH
CAGTAACAGTGAAGTT	BR1
CAGTAACGTTTACTCT	BR1
CAGTAACTCTGATTCT	BR1
CAGTCCTGTACATCCA	MGH
CAGTCCTGTTTCGCTC	BR1
CAGTCCTTCGGTGTCG	MGH
CAGTCCTTCTCCGGTT	BR1
CATATGGAGCAGATCG	VU
CATATGGAGTGTTTGC	BR1
CATATGGCACGAAACG	MGH
CATATGGCAGAGTGTG	BR1
CATATGGCAGGATTGG	MGH
CATATGGCATATGCTG	BR1
CATATGGCATCACAAC	BR1
CATATGGCATTATCTC	VU
CATATGGCATTCTCAT	MGH
CATATGGGTAAGGGAA	MGH
CATATGGGTCTCCATC	MGH
CATATGGTCCGCAGTG	BR1
CATATTCAGTGTACCT	VU
CATATTCCAAGGCTCC	MGH
CATATTCCAATGGAAT	BR1
CATATTCCAGATCTGT	MGH
CATATTCCATTCCTCG	MGH
CATATTCGTCTTCGTC	BR1
CATATTCGTTAGATGA	BR1
CATATTCTCAGCCTAA	MGH
CATATTCTCGTCCGTT	VU
CATCAAGAGGACTGGT	VU
CATCAAGCACCAGTTA	VU
CATCAAGGTTCAGACT	MGH
CATCAAGTCTTAACCT	MGH
CATCAGAAGCTGGAAC	BR1
CATCAGAAGTCATCCA	VU
CATCAGACACGTCAGC	MGH
CATCAGAGTGCAACGA	MGH
CATCAGAGTTATGTGC	MGH
CATCAGATCAGGTAAA	MGH
CATCAGATCGACCAGC	MGH
CATCAGATCTTTCCTC	MGH
CATCCACAGACTGGGT	BR1
CATCCACCACAGAGGT	MGH
CATCCACCATGCCCGA	VU
CATCCACTCCCTCAGT	BR1
CATCCACTCCGGCACA	MGH
CATCGAAAGCCACTAT	BR1
CATCGAAAGGACAGAA	VU
CATCGAACAAAGTCAA	MGH
CATCGAACAATGGACG	BR1
CATCGAAGTCCGAACC	BR1
CATCGAAGTCCGTTAA	BR1
CATCGAAGTCTTCAAG	MGH
CATCGAAGTGACTACT	MGH
CATCGAAGTTCACGGC	BR1
CATCGAATCAGTTGAC	BR1
CATCGAATCATGTAGC	BR1
CATCGAATCTGGTTCC	BR1
CATCGAATCTTGTACT	MGH
CATCGGGAGTATGACA	BR1
CATCGGGCAATAACGA	MGH
CATCGGGCAATCGGTT	BR1
CATCGGGCACGGTGTC	BR1
CATCGGGCAGTAAGCG	VU
CATCGGGCATACAGCT	BR1
CATCGGGCATACTACG	MGH
CATCGGGCATTCCTGC	BR1
CATCGGGGTAGCGTGA	VU
CATCGGGTCGCGTAGC	VU
CATGACAAGGAGTTTA	BR1
CATGACACACCACCAG	MGH
CATGACACAGCTGTGC	VU
CATGACAGTACCAGTT	BR1
CATGACAGTTGGACCC	MGH
CATGACATCATGCATG	MGH
CATGCCTAGTGTCCCG	MGH
CATGCCTAGTTCGATC	MGH
CATGCCTGTGATAAAC	BR1
CATGCCTGTGCAGGTA	BR1
CATGCCTTCATAGCAC	MGH
CATGGCGAGCTCCCAG	MGH
CATGGCGAGCTGCGAA	BR1
CATGGCGCAAGCCCAC	MGH
CATGGCGCAATGTTGC	MGH
CATGGCGCAGAGTGTG	MGH
CATGGCGTCCTATTCA	MGH
CATTATCGTACAGTTC	VU
CATTATCGTACCGCTG	BR1
CATTATCGTCAAAGCG	BR1
CATTATCGTCCAAGTT	BR1
CATTATCGTCGCGAAA	BR1
CATTATCGTCTTCAAG	BR1
CATTATCGTTAAAGTG	BR1
CATTATCGTTCCCTTG	MGH
CATTATCGTTTACTCT	BR1
CATTCGCAGCAACGGT	BR1
CATTCGCCACGGACAA	BR1
CATTCGCCATTGTGCA	BR1
CATTCGCGTATGAATG	MGH
CATTCGCGTCAGAGGT	MGH
CATTCGCTCGCCCTTA	BR1
CATTCGCTCTGCTTGC	BR1
CATTCGCTCTGGAGCC	MGH
CATTCGCTCTTAACCT	MGH
CCAATCCAGAAACCAT	BR1
CCAATCCAGTTGAGAT	VU
CCAATCCCAAGTACCT	MGH
CCAATCCCACCCTATC	BR1
CCAATCCGTAGAGCTG	MGH
CCAATCCGTATTCGTG	MGH
CCAATCCGTCGAGATG	VU
CCAATCCGTTCAGTAC	BR1
CCACCTAAGGCTAGCA	MGH
CCACCTAGTCGTGGCT	BR1
CCACCTAGTGGCTCCA	BR1
CCACCTAGTTATCACG	BR1
CCACCTATCATGTCTT	MGH
CCACCTATCTGACCTC	MGH
CCACGGAAGAAGAAGC	MGH
CCACGGAAGGAATTAC	MGH
CCACGGAAGGCCGAAT	VU
CCACGGAAGGGAGTAA	VU
CCACGGACAAGCTGAG	BR1
CCACGGACACCTCGGA	BR1
CCACGGACAGTGACAG	BR1
CCACGGAGTGAGGGAG	VU
CCACGGATCTTGTCAT	VU
CCACTACAGGAATCGC	MGH
CCACTACAGGAATTAC	BR1
CCACTACAGTGGGCTA	MGH
CCACTACCACGGCTAC	BR1
CCACTACCAGCCTGTG	BR1
CCACTACGTTGTGGAG	BR1
CCACTACTCACGAAGG	MGH
CCAGCGACACTTCTGC	BR1
CCAGCGACAGATCGGA	MGH
CCAGCGACAGGAATGC	VU
CCAGCGACATGTAGTC	BR1
CCAGCGAGTGCTGTAT	VU
CCAGCGATCACCTCGT	BR1
CCATGTCAGAGCTTCT	BR1
CCATGTCAGGCATGTG	BR1
CCATGTCCACTAAGTC	MGH
CCATGTCCAGGGTACA	BR1
CCATGTCGTCATGCAT	BR1
CCATGTCGTCATGCCG	VU
CCATGTCGTGTTGAGG	BR1
CCATGTCTCGAGAACG	VU
CCATTCGAGAGCTGGT	MGH
CCATTCGAGCTCTCGG	BR1
CCATTCGCAAGCCGTC	MGH
CCATTCGCAATAACGA	BR1
CCATTCGCACAAGCCC	MGH
CCATTCGCAGCTTAAC	BR1
CCATTCGGTCGAGTTT	MGH
CCATTCGGTTCAACCA	BR1
CCATTCGGTTGCCTCT	MGH
CCCAATCAGCACACAG	MGH
CCCAATCCAGGTGGAT	BR1
CCCAATCGTCTCACCT	MGH
CCCAATCGTGTGCCTG	MGH
CCCAATCGTTCCACTC	MGH
CCCAATCTCAACGGCC	MGH
CCCAATCTCTTGCCGT	MGH
CCCAATCTCTTTAGTC	MGH
CCCAGTTAGTGCTGCC	MGH
CCCAGTTCAGGGCATA	BR1
CCCAGTTCAGTTCCCT	BR1
CCCAGTTCATGAAGTA	MGH
CCCAGTTGTCGCGTGT	BR1
CCCAGTTGTTGTTTGG	BR1
CCCAGTTTCTGTACGA	MGH
CCCAGTTTCTTGCAAG	BR1
CCCATACAGAAGGACA	MGH
CCCATACAGCCACGTC	BR1
CCCATACAGGCATTGG	BR1
CCCATACCAAGCCGTC	BR1
CCCATACCAGGACGTA	BR1
CCCATACCAGTGAGTG	BR1
CCCATACCATGTCGAT	BR1
CCCATACGTACCGTTA	BR1
CCCATACGTTCAGGCC	BR1
CCCATACTCTAACTGG	MGH
CCCTCCTAGGATGTAT	MGH
CCCTCCTCAAGCGATG	MGH
CCCTCCTCAGCTGTTA	BR1
CCCTCCTGTGCTCTTC	MGH
CCCTCCTGTGTGACCC	MGH
CCCTCCTTCCTCGCAT	MGH
CCCTCCTTCTGCTGCT	BR1
CCGGGATAGCATGGCA	VU
CCGGGATAGGCGCTCT	MGH
CCGGGATAGGGATACC	MGH
CCGGGATCAATCTGCA	VU
CCGGGATCAATTCCTT	MGH
CCGGGATCAGCTGCTG	BR1
CCGGGATCATCTCGCT	BR1
CCGGGATGTCGACTGC	MGH
CCGGGATGTGTGGTTT	MGH
CCGGGATGTTCCTCCA	MGH
CCGGGATGTTCTGTTT	MGH
CCGGGATTCAGTGTTG	BR1
CCGGGATTCATTTGGG	BR1
CCGGGATTCGAATGCT	BR1
CCGGGATTCTAAGCCA	BR1
CCGGTAGAGAGACGAA	MGH
CCGGTAGAGAGGGCTT	BR1
CCGGTAGAGCGTAATA	BR1
CCGGTAGAGGACACCA	MGH
CCGGTAGCACCAGCAC	MGH
CCGGTAGGTATAAACG	VU
CCGGTAGGTCATATGC	VU
CCGGTAGGTCCAGTAT	BR1
CCGGTAGGTGTGAAAT	MGH
CCGGTAGTCATCTGTT	VU
CCGGTAGTCCCAAGAT	MGH
CCGTACTAGACAAGCC	BR1
CCGTACTAGATGGGTC	VU
CCGTACTAGCGACGTA	VU
CCGTACTAGTGGTCCC	VU
CCGTACTCACTAGTAC	BR1
CCGTACTCAGACGCTC	BR1
CCGTACTCAGCCACCA	BR1
CCGTACTGTACAGACG	MGH
CCGTGGAAGTACCGGA	MGH
CCGTGGACAATAGAGT	BR1
CCGTGGATCGCATGAT	VU
CCGTGGATCTTTACGT	MGH
CCGTTCAAGAAAGTGG	BR1
CCGTTCAAGACTACAA	MGH
CCGTTCACACACCGAC	BR1
CCGTTCACATATGAGA	BR1
CCGTTCACATATGCTG	MGH
CCGTTCACATGAGCGA	BR1
CCGTTCAGTCCGAACC	BR1
CCGTTCATCAACTCTT	VU
CCGTTCATCTGCCAGG	MGH
CCGTTCATCTTCATGT	MGH
CCTAAAGCAATGCCAT	BR1
CCTAAAGGTGAAAGAG	BR1
CCTAAAGGTGCAGTAG	MGH
CCTAAAGTCATAGCAC	BR1
CCTAAAGTCGGTGTTA	BR1
CCTACACAGAATTCCC	MGH
CCTACACAGACTGGGT	MGH
CCTACACAGGGTGTTG	BR1
CCTACACCATCGACGC	MGH
CCTACACCATTTCACT	MGH
CCTACACGTTGGACCC	BR1
CCTACACTCGTGGTCG	MGH
CCTACACTCTGTCAAG	VU
CCTACCAAGCCAGGAT	MGH
CCTACCAGTGATAAGT	BR1
CCTACCATCTCGAGTA	BR1
CCTAGCTAGATCCGAG	BR1
CCTAGCTAGCTCTCGG	BR1
CCTAGCTAGGCAATTA	MGH
CCTAGCTAGGCCCTTG	VU
CCTAGCTCACATAACC	BR1
CCTAGCTCACGGATAG	BR1
CCTAGCTCAGGGTTAG	MGH
CCTAGCTCAGTCAGCC	BR1
CCTAGCTTCAACACTG	VU
CCTAGCTTCCGAACGC	MGH
CCTATTAAGTGAATTG	MGH
CCTATTAGTACTCGCG	MGH
CCTATTAGTGGTACAG	MGH
CCTCAGTAGTCGATAA	BR1
CCTCAGTAGTGTTAGA	MGH
CCTCAGTCAAGCTGTT	MGH
CCTCAGTCACACCGAC	BR1
CCTCAGTGTACAGACG	BR1
CCTCAGTTCAACGCTA	VU
CCTCAGTTCGCGTTTC	BR1
CCTCAGTTCGTTTAGG	BR1
CCTCAGTTCTGTACGA	MGH
CCTCTGAAGCCGATTT	BR1
CCTCTGAAGTAGGCCA	BR1
CCTCTGACACCTTGTC	BR1
CCTCTGACAGCCAGAA	MGH
CCTCTGACAGTATCTG	MGH
CCTCTGAGTGAAATCA	BR1
CCTCTGAGTTCATGGT	BR1
CCTCTGATCACTGGGC	BR1
CCTCTGATCCAGAAGG	BR1
CCTCTGATCCTCCTAG	MGH
CCTCTGATCGCTTAGA	BR1
CCTCTGATCTCTGAGA	MGH
CCTCTGATCTGAGGGA	VU
CCTCTGATCTGGTGTA	BR1
CCTTACGAGATATGCA	BR1
CCTTACGAGGCGATAC	VU
CCTTACGAGTGGAGAA	MGH
CCTTACGCATCGTCGG	MGH
CCTTACGCATGAACCT	BR1
CCTTACGTCAATACCG	BR1
CCTTACGTCGGCGCAT	MGH
CCTTACGTCTGTCTCG	BR1
CCTTACGTCTTATCTG	BR1
CCTTCCCAGGTTCCTA	MGH
CCTTCCCCAAGCGAGT	BR1
CCTTCCCCAGACGCAA	VU
CCTTCCCCAGTCAGCC	MGH
CCTTCCCGTACGACCC	MGH
CCTTCCCGTTATGCGT	MGH
CCTTCCCGTTGAGTTC	VU
CCTTCCCTCCCTAACC	BR1
CCTTCCCTCGACCAGC	MGH
CCTTCCCTCGGGAGTA	VU
CCTTCCCTCTTGACGA	MGH
CCTTCGAAGAGGGCTT	BR1
CCTTCGAAGATATGCA	BR1
CCTTCGAGTCGAGTTT	BR1
CCTTCGAGTCGGCTCA	BR1
CCTTCGATCATCTGTT	VU
CCTTCGATCCCAAGTA	BR1
CCTTCGATCGACAGCC	BR1
CCTTCGATCTATGTGG	BR1
CCTTTCTAGAGCCTAG	BR1
CCTTTCTAGCTGCCCA	MGH
CCTTTCTAGGGTGTGT	BR1
CCTTTCTCAGCTTCGG	MGH
CCTTTCTCAGTCTTCC	VU
CCTTTCTGTTCCACGG	BR1
CCTTTCTTCCTGTACC	VU
CCTTTCTTCGGAATCT	VU
CCTTTCTTCTGCTGTC	BR1
CGAACATAGATAGGAG	MGH
CGAACATAGTGTCCAT	MGH
CGAACATCACACCGCA	VU
CGAACATCATTGCGGC	MGH
CGAACATGTAAGTAGT	MGH
CGAACATGTAGCGATG	VU
CGAACATGTCCGTTAA	VU
CGAATGTAGACCCACC	MGH
CGAATGTAGCGATGAC	BR1
CGAATGTAGCTGATAA	BR1
CGAATGTGTACATCCA	BR1
CGAATGTGTAGAAGGA	BR1
CGAATGTGTATAAACG	BR1
CGAATGTGTCTAACGT	BR1
CGAATGTGTTTACTCT	BR1
CGAATGTTCCTGTAGA	BR1
CGAATGTTCTTCCTTC	MGH
CGACCTTAGCCGATTT	MGH
CGACCTTAGTCGCCGT	BR1
CGACCTTAGTGCGTGA	MGH
CGACCTTCAAGTCTAC	BR1
CGACCTTCACAGACAG	VU
CGACCTTGTAGCAAAT	MGH
CGACCTTGTGTTGAGG	BR1
CGACCTTTCATGCAAC	BR1
CGACCTTTCCTGCAGG	VU
CGACCTTTCTATGTGG	BR1
CGACTTCAGACATAAC	BR1
CGACTTCGTGATAAGT	MGH
CGACTTCTCGCTAGCG	MGH
CGACTTCTCTACTATC	BR1
CGAGAAGAGCTAAGAT	MGH
CGAGAAGGTCGACTGC	MGH
CGAGAAGGTTAAGATG	BR1
CGAGAAGTCACATACG	VU
CGAGAAGTCGTAGGTT	MGH
CGAGCACAGCGTAATA	BR1
CGAGCACAGGGCTCTC	MGH
CGAGCACAGTGTTTGC	BR1
CGAGCACCACGGTGTC	BR1
CGAGCACGTCCAGTAT	BR1
CGAGCACGTCTCGTTC	MGH
CGAGCACGTTACCGAT	BR1
CGAGCACGTTGCGCAC	MGH
CGAGCACGTTGTTTGG	BR1
CGAGCACTCATCGATG	MGH
CGAGCACTCCCGACTT	BR1
CGAGCCAAGCCGCCTA	BR1
CGAGCCAGTTCTCATT	VU
CGATCGGAGTCAAGGC	BR1
CGATCGGAGTCCAGGA	BR1
CGATCGGCATAGAAAC	MGH
CGATCGGCATAGGATA	BR1
CGATCGGCATCGGACC	MGH
CGATCGGGTAGCTTGT	BR1
CGATCGGGTTAAGTAG	BR1
CGATCGGGTTCAGCGC	BR1
CGATCGGTCAAGAAGT	BR1
CGATCGGTCTTTACGT	MGH
CGATGGCTCAAACGGG	BR1
CGATGGCTCGTACCGG	VU
CGATGGCTCTTTACGT	BR1
CGATGTAAGGAGTCTG	BR1
CGATGTAAGGTAGCTG	MGH
CGATGTAAGTTTAGGA	VU
CGATGTAGTCCGTGAC	BR1
CGATGTAGTCGGCATC	BR1
CGATGTATCCGTCAAA	MGH
CGATTGAAGACCGGAT	BR1
CGATTGACATGGAATA	BR1
CGATTGAGTGCGCTTG	BR1
CGATTGAGTGTTTGGT	BR1
CGATTGATCAACCATG	MGH
CGATTGATCCTCCTAG	VU
CGCCAAGAGCTGAAAT	BR1
CGCCAAGAGGCCGAAT	VU
CGCCAAGAGTGTTAGA	MGH
CGCCAAGCAAACGCGA	BR1
CGCCAAGCACAAGCCC	MGH
CGCCAAGGTCTGCAAT	VU
CGCCAAGTCGTTTGCC	BR1
CGCGGTAAGTATTGGA	BR1
CGCGGTACAAGTCTGT	BR1
CGCGGTACATCCCACT	BR1
CGCGGTAGTAGCACGA	MGH
CGCGGTAGTAGCGTAG	BR1
CGCGGTAGTTCACCTC	MGH
CGCGGTATCCCAACGG	MGH
CGCGGTATCTTAGCCC	BR1
CGCGTTTAGATGCCAG	BR1
CGCGTTTAGCTAGGCA	BR1
CGCGTTTAGGATCGCA	BR1
CGCGTTTAGTCAATAG	BR1
CGCGTTTAGTTACCCA	VU
CGCGTTTAGTTGTCGT	MGH
CGCGTTTCAAAGGCGT	VU
CGCGTTTCAGTATAAG	BR1
CGCGTTTGTCAGTGGA	MGH
CGCGTTTGTTCTGTTT	VU
CGCGTTTTCTCAAACG	BR1
CGCTATCAGACTGGGT	VU
CGCTATCAGCGTTCCG	BR1
CGCTATCAGGAACTGC	MGH
CGCTATCCAGTAGAGC	MGH
CGCTATCGTAGCGATG	BR1
CGCTATCGTGATAAAC	BR1
CGCTATCTCATTCACT	MGH
CGCTATCTCCGTAGTA	BR1
CGCTATCTCGTACCGG	VU
CGCTATCTCTTAACCT	MGH
CGCTGGAAGAGTACAT	MGH
CGCTGGAAGCTTCGCG	MGH
CGCTGGACACGAAAGC	MGH
CGCTGGACAGTCCTTC	VU
CGCTGGAGTAGTACCT	VU
CGCTGGAGTCTGATCA	BR1
CGCTGGAGTTCCCGAG	BR1
CGCTGGATCGGCGCTA	BR1
CGCTGGATCTGCTTGC	MGH
CGCTTCAAGACGCTTT	BR1
CGCTTCAAGTATCGAA	MGH
CGCTTCACAGGAATCG	BR1
CGCTTCAGTCAGCTAT	VU
CGCTTCAGTGGAAAGA	VU
CGCTTCATCACGACTA	MGH
CGCTTCATCCAAAGTC	MGH
CGGACACAGACTAAGT	MGH
CGGACACCAATTGCTG	VU
CGGACACCATACTACG	MGH
CGGACACCATGCGCAC	MGH
CGGACACGTAGATTAG	MGH
CGGACACGTCTCCACT	VU
CGGACACGTCTTCGTC	BR1
CGGACACGTTAAGATG	BR1
CGGACACTCTTGCATT	MGH
CGGACACTCTTTAGGG	MGH
CGGACGTAGCCAGTTT	BR1
CGGACGTAGGACCACA	MGH
CGGACGTAGGCTACGA	MGH
CGGACGTAGTACATGA	BR1
CGGACGTAGTGGTCCC	MGH
CGGACGTCAAGTAGTA	BR1
CGGACGTCAGCTGTAT	MGH
CGGACGTGTCCGTTAA	MGH
CGGACGTGTCTAGAGG	BR1
CGGACGTGTGCCTGCA	MGH
CGGACGTTCAGTTAGC	BR1
CGGACGTTCCGATATG	VU
CGGACGTTCCTTTCTC	MGH
CGGACGTTCGCAAACT	BR1
CGGACTGAGGACAGCT	MGH
CGGACTGAGTTGCAGG	VU
CGGACTGGTTAGATGA	VU
CGGACTGGTTCAGCGC	BR1
CGGACTGTCTTTCCTC	BR1
CGGAGCTAGACAGAGA	BR1
CGGAGCTCAGCTCGAC	MGH
CGGAGCTGTAACGCGA	MGH
CGGAGCTGTCTTGCGG	VU
CGGAGCTGTGCAGGTA	VU
CGGAGCTTCACCTCGT	VU
CGGAGCTTCCACGACG	MGH
CGGAGCTTCGTCTGCT	BR1
CGGAGTCAGCCCTAAT	VU
CGGAGTCAGTACATGA	VU
CGGAGTCAGTTAGCGG	MGH
CGGAGTCCAAGGCTCC	BR1
CGGAGTCCACAGATTC	MGH
CGGAGTCCACTAAGTC	BR1
CGGAGTCTCCACTCCA	BR1
CGGAGTCTCTATCCTA	BR1
CGGCTAGAGGCTCTTA	MGH
CGGCTAGCAACGATCT	MGH
CGGCTAGCAACGATGG	BR1
CGGCTAGGTAGCGCAA	BR1
CGGCTAGTCTGTTGAG	MGH
CGGGTCAAGATGGGTC	BR1
CGGGTCACAAGCCATT	BR1
CGGGTCACATCGACGC	BR1
CGGGTCAGTCCAGTTA	BR1
CGGGTCAGTCGGATCC	VU
CGGGTCAGTCTCGTTC	MGH
CGGGTCATCAGATAAG	MGH
CGGGTCATCATTGCCC	BR1
CGGGTCATCCGCGGTA	VU
CGGTTAAAGCTGCGAA	MGH
CGGTTAAAGGACAGCT	MGH
CGGTTAAAGGCGACAT	BR1
CGGTTAAAGTTGCAGG	VU
CGGTTAACACTATCTT	BR1
CGGTTAACATGCCCGA	MGH
CGGTTAACATTTCAGG	VU
CGGTTAAGTACCGTTA	MGH
CGGTTAATCTCGGACG	BR1
CGTAGCGAGCTGCCCA	MGH
CGTAGCGGTCATCCCT	VU
CGTAGCGGTCTAGAGG	BR1
CGTAGCGTCATAAAGG	BR1
CGTAGCGTCATCGCTC	BR1
CGTAGCGTCCCTGACT	VU
CGTAGGCAGTTAGCGG	BR1
CGTAGGCAGTTATCGC	BR1
CGTAGGCCACCATGTA	VU
CGTAGGCCACTTCGAA	BR1
CGTAGGCCATGAGCGA	MGH
CGTAGGCGTAGGGACT	BR1
CGTAGGCGTCATCGGC	BR1
CGTAGGCTCAAGGCTT	BR1
CGTAGGCTCAGTGTTG	BR1
CGTAGGCTCTTAACCT	VU
CGTAGGCTCTTATCTG	MGH
CGTCACTAGCGTAGTG	MGH
CGTCACTAGTGCGATG	MGH
CGTCACTCAAGAAAGG	BR1
CGTCACTCATCCCATC	BR1
CGTCACTCATTTCAGG	MGH
CGTCACTGTATGCTTG	BR1
CGTCACTGTCATCCCT	VU
CGTCACTTCGCAAGCC	BR1
CGTCACTTCTGCAAGT	MGH
CGTCACTTCTTAACCT	BR1
CGTCACTTCTTCCTTC	MGH
CGTCAGGAGAAGGGTA	MGH
CGTCAGGAGATCCCGC	BR1
CGTCAGGAGCCAGTAG	BR1
CGTCAGGCAGGGTACA	VU
CGTCAGGCAGTTCCCT	MGH
CGTCAGGCATGTCTCC	VU
CGTCAGGGTACAGTGG	VU
CGTCAGGTCCCTCTTT	BR1
CGTCCATAGATGCCAG	VU
CGTCCATAGCTCCTCT	BR1
CGTCCATAGGAGCGTT	VU
CGTCCATAGTGTTTGC	BR1
CGTCCATCAAGCCGCT	BR1
CGTCCATCACGGACAA	MGH
CGTCCATGTATGCTTG	BR1
CGTCCATGTGAACCTT	BR1
CGTCCATGTGTGGTTT	MGH
CGTCCATTCACAATGC	BR1
CGTCCATTCTCTGTCG	BR1
CGTCTACAGATCGGGT	MGH
CGTCTACAGTGTGGCA	BR1
CGTCTACCAGTCGTGC	BR1
CGTCTACCATACTCTT	VU
CGTCTACCATTTCACT	VU
CGTCTACGTATTCTCT	BR1
CGTCTACTCGCCTGAG	VU
CGTGAGCAGACAAGCC	BR1
CGTGAGCAGGATTCGG	MGH
CGTGAGCAGGGTGTTG	MGH
CGTGAGCAGTTGTAGA	BR1
CGTGAGCCAAACTGCT	VU
CGTGAGCTCTGCGTAA	MGH
CGTGAGCTCTGTTTGT	VU
CGTGTAAAGCCAACAG	BR1
CGTGTAACACAAGTAA	MGH
CGTGTAACAGACGTAG	BR1
CGTGTAAGTGGCGAAT	BR1
CGTGTAATCCTATTCA	MGH
CGTGTAATCCTTCAAT	BR1
CGTGTCTAGAAGGACA	MGH
CGTGTCTAGACCTTTG	BR1
CGTGTCTAGTAGATGT	BR1
CGTGTCTAGTCCGTAT	BR1
CGTGTCTAGTGCTGCC	BR1
CGTGTCTCAAGCGATG	VU
CGTGTCTCACGAGGTA	BR1
CGTGTCTGTACAGACG	MGH
CGTGTCTTCAACTCTT	BR1
CGTGTCTTCCGTAGTA	VU
CGTGTCTTCCTTCAAT	BR1
CGTGTCTTCGCGTTTC	BR1
CGTGTCTTCTGCGACG	MGH
CGTTAGAAGTCTCGGC	MGH
CGTTAGAAGTGAATTG	BR1
CGTTAGACAATAGAGT	VU
CGTTAGACAGACGCTC	MGH
CGTTAGACAGGTGCCT	MGH
CGTTAGAGTATATGAG	MGH
CGTTAGAGTGCTGTAT	BR1
CGTTCTGAGGCCGAAT	BR1
CGTTCTGCAGGGTATG	BR1
CGTTCTGGTTAAAGAC	MGH
CGTTCTGTCAGGTTCA	BR1
CGTTCTGTCCGCTGTT	MGH
CGTTGGGAGGTGGGTT	VU
CGTTGGGCACCTTGTC	MGH
CGTTGGGCATCCGGGT	VU
CGTTGGGGTAATAGCA	BR1
CGTTGGGGTGCCTGCA	BR1
CGTTGGGGTGCTCTTC	VU
CGTTGGGGTGGTAACG	VU
CTAACTTAGACATAAC	BR1
CTAACTTAGGGAACGG	BR1
CTAACTTAGTGGTCCC	MGH
CTAACTTTCGTGACAT	VU
CTAACTTTCGTGGACC	BR1
CTAAGACAGCCCGAAA	MGH
CTAAGACAGCTTATCG	VU
CTAAGACAGTTGCAGG	MGH
CTAAGACGTAGGCTGA	BR1
CTAAGACGTGTGACCC	BR1
CTAAGACTCTCATTCA	BR1
CTAATGGAGACAATAC	BR1
CTAATGGAGCTTTGGT	VU
CTAATGGCACTGAAGG	BR1
CTAATGGCAGCGTCCA	BR1
CTAATGGCATACAGCT	BR1
CTAATGGGTAATAGCA	BR1
CTACACCAGAGTCGGT	BR1
CTACACCAGGCAGTCA	BR1
CTACACCCAATAGCAA	BR1
CTACACCCACGACTCG	BR1
CTACACCCAGCTGTTA	VU
CTACACCCAGGTGGAT	BR1
CTACACCCAGTCGATT	VU
CTACACCGTACAGTTC	MGH
CTACACCGTATATGAG	VU
CTACACCGTCCGACGT	BR1
CTACACCGTGCAACTT	BR1
CTACACCGTTCGTTGA	BR1
CTACATTCAAGGTTTC	BR1
CTACATTTCAGCTCTC	MGH
CTACATTTCTCGCATC	MGH
CTACCCAAGCTAGGCA	MGH
CTACCCAAGCTAGTTC	MGH
CTACCCAAGGAGCGTT	BR1
CTACCCAAGGCCCGTT	VU
CTACCCAAGGCCCTCA	MGH
CTACCCAAGTCCCACG	VU
CTACCCAAGTCCTCCT	BR1
CTACCCAGTACAAGTA	MGH
CTACCCATCTGACCTC	MGH
CTACGTCAGAGCTTCT	MGH
CTACGTCCACATAACC	MGH
CTACGTCTCATCGGAT	BR1
CTACGTCTCCTATTCA	MGH
CTACGTCTCTCACATT	BR1
CTAGAGTAGACCTTTG	MGH
CTAGAGTGTGTCAATC	MGH
CTAGAGTGTTGGTGGA	MGH
CTAGAGTGTTTGTTGG	BR1
CTAGAGTTCGCGGATC	MGH
CTAGCCTAGACTTTCG	BR1
CTAGCCTAGCTAGTTC	MGH
CTAGCCTGTAAGAGGA	MGH
CTAGCCTGTCTTCTCG	BR1
CTAGTGAAGCGATCCC	MGH
CTAGTGAAGCTTATCG	BR1
CTAGTGACACCTCGGA	BR1
CTAGTGACACTGTGTA	VU
CTAGTGACAGATCTGT	MGH
CTAGTGAGTGAAGGCT	BR1
CTAGTGAGTGCAACGA	VU
CTAGTGAGTTCTGGTA	BR1
CTAGTGATCCTTGACC	BR1
CTAGTGATCTGCTGCT	BR1
CTCACACAGATAGGAG	MGH
CTCACACTCATAAAGG	BR1
CTCACACTCGATAGAA	MGH
CTCAGAAAGAATTGTG	BR1
CTCAGAAAGACAGGCT	MGH
CTCAGAAGTACAGTGG	BR1
CTCAGAAGTCACCCAG	VU
CTCAGAAGTCGCGTGT	BR1
CTCAGAAGTCTTGCGG	MGH
CTCAGAATCCGTAGTA	MGH
CTCATTAAGAAGCCCA	BR1
CTCATTAAGTACATGA	MGH
CTCATTACACGAAATA	VU
CTCATTACAGGGTACA	MGH
CTCATTAGTAACGCGA	MGH
CTCATTAGTACTCTCC	MGH
CTCATTAGTAGAAGGA	BR1
CTCATTAGTGTTCGAT	MGH
CTCATTAGTTCTCATT	BR1
CTCATTAGTTGTGGAG	BR1
CTCATTATCGGAGGTA	BR1
CTCATTATCGTGGGAA	BR1
CTCCTAGAGTAGCGGT	BR1
CTCCTAGCAATGAATG	VU
CTCCTAGCAGCTCCGA	VU
CTCCTAGGTGGAAAGA	VU
CTCCTAGGTTCAGCGC	BR1
CTCGAAAAGGCTACGA	MGH
CTCGAAAGTACTTCTT	BR1
CTCGAAAGTTCGTTGA	BR1
CTCGAGGAGAGTACAT	BR1
CTCGAGGAGCTAAACA	MGH
CTCGAGGAGGCAAAGA	BR1
CTCGAGGCAGCGATCC	BR1
CTCGAGGGTCGACTGC	MGH
CTCGAGGGTCTGGAGA	MGH
CTCGAGGGTTTGGCGC	MGH
CTCGAGGTCCAAGCCG	BR1
CTCGAGGTCCGTTGTC	BR1
CTCGGAGAGAAGGGTA	MGH
CTCGGAGAGAGCTGGT	BR1
CTCGGAGAGCCTTGAT	VU
CTCGGAGAGCTAGTCT	BR1
CTCGGAGAGTAGGCCA	VU
CTCGGAGCACCAGATT	MGH
CTCGGAGCACTGCCAG	MGH
CTCGGAGCAGGACCCT	VU
CTCGGAGGTATCTGCA	MGH
CTCGGAGGTTACCGAT	BR1
CTCGGAGGTTGTTTGG	BR1
CTCGGAGTCAATCACG	BR1
CTCGGAGTCATGCTCC	BR1
CTCGGAGTCCTCAACC	BR1
CTCGGAGTCGGTTCGG	BR1
CTCGGGAAGAACTCGG	BR1
CTCGGGAAGATCGATA	BR1
CTCGGGAAGCTAGCCC	MGH
CTCGGGAAGTACGACG	BR1
CTCGGGACAAGGACAC	MGH
CTCGGGACAAGGGTCA	MGH
CTCGGGAGTCTTGCGG	MGH
CTCGGGATCAAAGTAG	MGH
CTCGTACCACATTAGC	VU
CTCGTACCATTTCACT	BR1
CTCGTACGTAGAGGAA	MGH
CTCGTACGTAGCGCTC	MGH
CTCGTACTCCTACAGA	BR1
CTCGTACTCCTCTAGC	MGH
CTCGTACTCGCCGTGA	BR1
CTCGTCACAACGCACC	MGH
CTCGTCACACCAGCAC	MGH
CTCGTCACATAGACTC	BR1
CTCGTCAGTAAGAGAG	BR1
CTCGTCATCAGCGACC	BR1
CTCGTCATCTATCGCC	BR1
CTCGTCATCTTCTGGC	BR1
CTCTAATAGCAGGTCA	BR1
CTCTAATAGTCAAGCG	BR1
CTCTAATAGTCTTGCA	MGH
CTCTAATCACATCCGG	MGH
CTCTAATCACCGAATT	MGH
CTCTAATCATCAGTAC	VU
CTCTAATGTAAATACG	BR1
CTCTAATGTCGCGGTT	BR1
CTCTAATGTTAGAACA	MGH
CTCTACGAGACGCTTT	BR1
CTCTACGAGCGTTTAC	MGH
CTCTACGAGGCAAAGA	BR1
CTCTACGCATATGGTC	MGH
CTCTACGGTCTTGTCC	BR1
CTCTACGGTGCAACTT	BR1
CTCTACGGTTACCAGT	BR1
CTCTACGTCACTTCAT	MGH
CTCTACGTCTCTGCTG	BR1
CTCTGGTAGAGCCTAG	MGH
CTCTGGTAGCAATATG	MGH
CTCTGGTCAGATGAGC	BR1
CTCTGGTGTAGTACCT	MGH
CTCTGGTGTCATCCCT	MGH
CTCTGGTGTCTGATTG	MGH
CTCTGGTGTTGAACTC	VU
CTCTGGTTCACATGCA	MGH
CTCTGGTTCATAGCAC	VU
CTCTGGTTCCAAGTAC	BR1
CTGAAACAGAGGTACC	MGH
CTGAAACAGCTCCTCT	BR1
CTGAAACAGGAGCGTT	VU
CTGAAACCAATTCCTT	BR1
CTGAAACCACGTTGGC	BR1
CTGAAACGTTAGTGGG	BR1
CTGAAACTCAGAGCTT	VU
CTGAAGTAGTGTACCT	MGH
CTGAAGTCACTATCTT	BR1
CTGAAGTCAGTCCTTC	BR1
CTGAAGTGTACAGTTC	VU
CTGAAGTGTACGACCC	MGH
CTGAAGTTCAAACCAC	BR1
CTGAAGTTCTCGCTTG	MGH
CTGATAGAGCACACAG	BR1
CTGATAGAGGACAGAA	MGH
CTGATAGCAGACTCGC	BR1
CTGATAGGTAAGAGAG	MGH
CTGATCCCACAAGACG	MGH
CTGATCCCAGTTAACC	MGH
CTGATCCCATTCTCAT	MGH
CTGATCCGTACAGCAG	MGH
CTGATCCGTCGTTGTA	BR1
CTGATCCGTTGACGTT	BR1
CTGATCCTCGGATGTT	BR1
CTGCCTAAGGGATCTG	BR1
CTGCCTACACCGTTGG	MGH
CTGCCTAGTTAAAGAC	MGH
CTGCGGAAGCTAGTGG	MGH
CTGCGGAAGGGCACTA	VU
CTGCGGAAGGTGGGTT	BR1
CTGCGGACAAGGTTCT	BR1
CTGCGGACACTTACGA	MGH
CTGCGGACATGCTAGT	VU
CTGCGGAGTAGCACGA	MGH
CTGCGGAGTCTACCTC	VU
CTGCGGAGTGCTCTTC	MGH
CTGCGGAGTTCGGCAC	MGH
CTGCGGATCACATAGC	BR1
CTGCGGATCAGCATGT	BR1
CTGCTGTAGTACGATA	MGH
CTGCTGTCAGCTGTAT	MGH
CTGCTGTCAGGGATTG	BR1
CTGCTGTCATACCATG	BR1
CTGCTGTGTCCCTACT	MGH
CTGCTGTGTTATCGGT	BR1
CTGCTGTTCGCCGTGA	MGH
CTGCTGTTCTGCCCTA	MGH
CTGGTCTAGCCTCGTG	VU
CTGGTCTAGCGTTCCG	MGH
CTGGTCTAGTGGACGT	MGH
CTGGTCTAGTGTTTGC	MGH
CTGGTCTCAATACGCT	BR1
CTGGTCTCATTTGCCC	BR1
CTGGTCTTCAGGTAAA	VU
CTGTGCTAGATAGCAT	BR1
CTGTGCTAGCGATCCC	MGH
CTGTGCTTCATTTGGG	MGH
CTGTGCTTCCAACCAA	MGH
CTGTGCTTCCACTCCA	BR1
CTGTGCTTCTGCTTGC	MGH
CTGTTTAAGATCCCAT	MGH
CTGTTTAAGCACACAG	BR1
CTGTTTACAATAACGA	MGH
CTGTTTACACTCGACG	MGH
CTGTTTACAGATCTGT	BR1
CTGTTTACAGGTCCAC	MGH
CTGTTTATCACCAGGC	BR1
CTGTTTATCCTTGCCA	BR1
CTGTTTATCGAGCCCA	BR1
CTGTTTATCTGGTTCC	BR1
CTTAACTAGAGTCGGT	MGH
CTTAACTAGCGGATCA	MGH
CTTAACTAGCTAACTC	BR1
CTTAACTAGCTAGTTC	VU
CTTAACTAGTGTGGCA	VU
CTTAACTCAAACGTGG	MGH
CTTAACTCAATCCAAC	VU
CTTAACTCAGGGTTAG	MGH
CTTAACTCAGTGAGTG	BR1
CTTAACTGTCTCTCTG	MGH
CTTACCGAGGCGTACA	MGH
CTTACCGAGTCACGCC	MGH
CTTACCGGTGGCCCTA	BR1
CTTACCGGTTCTGAAC	MGH
CTTACCGGTTCTGGTA	MGH
CTTACCGGTTGCGCAC	BR1
CTTACCGTCGCTAGCG	MGH
CTTACCGTCGCTTGTC	BR1
CTTACCGTCGTTGCCT	BR1
CTTACCGTCTGTGCAA	BR1
CTTAGGACAATAGAGT	MGH
CTTAGGACACACCGCA	BR1
CTTAGGACACCACCAG	MGH
CTTAGGACAGACTCGC	VU
CTTAGGATCATTCACT	BR1
CTTAGGATCCAAAGTC	BR1
CTTAGGATCCCATTAT	VU
CTTAGGATCTGTCCGT	BR1
CTTCTCTAGAGTACCG	BR1
CTTCTCTCAGCGTTCG	BR1
CTTCTCTCATTACGAC	BR1
CTTCTCTGTCGGGTCT	MGH
CTTCTCTGTGTGAAAT	MGH
CTTCTCTTCAGCGACC	MGH
CTTCTCTTCGGCCGAT	MGH
CTTCTCTTCTTGCATT	BR1
CTTGGCTAGAGTGAGA	MGH
CTTGGCTAGCTGCAAG	VU
CTTGGCTCAGCGTTCG	BR1
CTTGGCTCAGCTTAAC	BR1
CTTTGCGAGCAAATCA	MGH
CTTTGCGAGGCTAGGT	BR1
CTTTGCGGTGCCTGTG	BR1
CTTTGCGGTTCGCTAA	BR1
CTTTGCGGTTGTCGCG	MGH
CTTTGCGGTTTGCATG	MGH
CTTTGCGTCATGTCTT	VU
GAAACTCCATTATCTC	VU
GAAACTCGTCCATGAT	MGH
GAAACTCGTCGCTTCT	BR1
GAAATGAAGAGTAATC	BR1
GAAATGACAAACTGTC	MGH
GAAATGACATTTCACT	VU
GAAATGAGTAAGTGTA	MGH
GAAATGAGTCCAGTGC	BR1
GAAATGAGTCCATGAT	BR1
GAAATGATCTGGGCCA	VU
GAACATCAGATAGCAT	BR1
GAACATCAGTAGATGT	BR1
GAACATCCAATCAGAA	BR1
GAACATCCACGGCCAT	BR1
GAACATCGTAGGGTAC	MGH
GAACATCGTCTAGTGT	BR1
GAACATCTCACTTCAT	VU
GAACATCTCATTGCCC	MGH
GAACATCTCCTAGTGA	MGH
GAACCTACAGTGGGAT	VU
GAACCTAGTGTTTGTG	VU
GAACCTAGTTCTCATT	VU
GAACCTATCGGATGGA	MGH
GAACCTATCGTTTGCC	MGH
GAACGGAAGGATGTAT	MGH
GAACGGACACCCATGG	MGH
GAACGGACAGCCTATA	MGH
GAACGGAGTCTTCGTC	BR1
GAACGGAGTTCGCGAC	BR1
GAACGGATCATTGCGA	MGH
GAACGGATCTGAGGGA	MGH
GAACGGATCTGTCTAT	MGH
GAAGCAGAGCGAAGGG	BR1
GAAGCAGAGCTGGAAC	BR1
GAAGCAGAGGCAATTA	BR1
GAAGCAGAGTGAATTG	VU
GAAGCAGAGTGATCGG	MGH
GAAGCAGCACCATCCT	MGH
GAAGCAGCAGTATGCT	MGH
GAAGCAGGTCATGCCG	BR1
GAAGCAGGTCGATTGT	BR1
GAAGCAGTCAACGGCC	MGH
GAAGCAGTCTAACTTC	MGH
GAAGCAGTCTGCAAGT	BR1
GAAGCAGTCTGCCCTA	MGH
GAATAAGAGCACGCCT	VU
GAATAAGAGGTGTTAA	VU
GAATAAGAGTGAAGTT	MGH
GAATAAGCACGCATCG	BR1
GAATAAGGTAGGAGTC	MGH
GAATAAGGTCCGAGTC	BR1
GAATAAGTCAATCTCT	MGH
GAATGAAAGGCAGGTT	BR1
GAATGAACAATCAGAA	BR1
GAATGAACAGCTGCAC	BR1
GAATGAACAGGGATTG	VU
GAATGAATCCATGAGT	MGH
GACACGCAGCAACGGT	VU
GACACGCAGTTTGCGT	BR1
GACACGCCACTAAGTC	BR1
GACACGCGTGTGACCC	MGH
GACACGCGTTAGGGTG	BR1
GACACGCTCAGTCAGT	MGH
GACACGCTCCTAAGTG	BR1
GACAGAGAGCTACCTA	VU
GACAGAGCAAATACAG	MGH
GACAGAGCAAGTTCTG	VU
GACAGAGCACACATGT	MGH
GACAGAGCAGGACCCT	VU
GACAGAGCAGGGTATG	VU
GACAGAGTCCCTGACT	MGH
GACAGAGTCGTAGGAG	BR1
GACCAATAGTGTACGG	VU
GACCAATCAAGAAGAG	MGH
GACCAATCATGATCCA	BR1
GACCAATGTAGCAAAT	MGH
GACCAATGTCAGAGGT	VU
GACCAATGTCGTCTTC	BR1
GACCAATGTGACCAAG	MGH
GACCAATTCTAACGGT	BR1
GACCAATTCTGCGGCA	MGH
GACCTGGAGACAGACC	BR1
GACCTGGAGAGCCTAG	BR1
GACCTGGAGGCCATAG	BR1
GACCTGGGTGGGTATG	BR1
GACCTGGGTTCCACAA	BR1
GACCTGGTCTGAAAGA	MGH
GACGCGTAGCCCTAAT	MGH
GACGCGTAGGGTTTCT	BR1
GACGCGTCAATAGAGT	VU
GACGCGTCACAGGTTT	VU
GACGCGTCACCTGGTG	MGH
GACGCGTCATACTACG	BR1
GACGCGTGTAAGTGTA	MGH
GACGCGTGTCGGCATC	VU
GACGCGTTCATACGGT	MGH
GACGGCTAGTGTACCT	MGH
GACGGCTCACATCTTT	VU
GACGGCTCAGCTGTTA	VU
GACGGCTGTCCGACGT	BR1
GACGGCTGTGCTCTTC	MGH
GACGGCTGTGTTTGGT	BR1
GACGGCTGTTCTGTTT	BR1
GACGGCTTCAATCTCT	BR1
GACGGCTTCCCTGACT	BR1
GACGGCTTCCGTTGTC	VU
GACGGCTTCCTTGACC	MGH
GACGGCTTCTACCTGC	BR1
GACGGCTTCTCAACTT	BR1
GACGTGCAGCGTTGCC	VU
GACGTGCAGTGGGCTA	VU
GACGTGCCAAGTCATC	VU
GACGTGCCAGTATGCT	BR1
GACGTGCGTCGAATCT	BR1
GACGTGCGTCTAGCGC	VU
GACGTGCGTGATAAAC	MGH
GACGTGCGTTCCACGG	BR1
GACGTGCTCTCTTGAT	BR1
GACGTTAAGCAGGTCA	MGH
GACGTTAAGTGCGTGA	BR1
GACGTTACAAGCCCAC	MGH
GACGTTAGTAAGGGCT	MGH
GACGTTAGTGCAGTAG	BR1
GACGTTAGTGCCTGTG	MGH
GACGTTATCAAGGTAA	MGH
GACGTTATCAGAGGTG	VU
GACGTTATCGACAGCC	BR1
GACGTTATCTTGCATT	MGH
GACTAACAGCCCAATT	BR1
GACTAACCAGATGGCA	MGH
GACTAACGTACATGTC	BR1
GACTAACGTCTAAAGA	MGH
GACTAACTCATGCATG	MGH
GACTAACTCTGCGACG	BR1
GACTACAAGGGATCTG	MGH
GACTACACAGCGTCCA	BR1
GACTACAGTAGATTAG	BR1
GACTACAGTTACCGAT	BR1
GACTACAGTTATGCGT	BR1
GACTACAGTTCGGCAC	BR1
GACTACATCCATGCTC	BR1
GACTGCGAGCATGGCA	MGH
GACTGCGCATGCCTTC	MGH
GACTGCGTCTCTGAGA	MGH
GAGCAGAAGGCGCTCT	VU
GAGCAGAAGTCCTCCT	VU
GAGCAGAAGTCGTACT	BR1
GAGCAGACAAGGGTCA	BR1
GAGCAGACATGGGAAC	MGH
GAGCAGAGTACTCTCC	MGH
GAGCAGAGTTTGGCGC	MGH
GAGCAGATCAGAGCTT	MGH
GAGCAGATCAGCTTAG	MGH
GAGCAGATCCCAGGTG	MGH
GAGCAGATCGGCGCTA	VU
GAGGTGAAGGACAGCT	MGH
GAGGTGACAAAGCGGT	MGH
GAGGTGACACCCAGTG	BR1
GAGGTGACACCGAAAG	MGH
GAGGTGACAGTAGAGC	MGH
GAGGTGACATTAGGCT	BR1
GAGGTGAGTTACTGAC	BR1
GAGGTGAGTTTAGCTG	MGH
GAGGTGATCCCTTGTG	MGH
GAGTCCGAGCACCGTC	MGH
GAGTCCGAGTGTACTC	MGH
GAGTCCGCACACGCTG	BR1
GAGTCCGGTAACGCGA	MGH
GAGTCCGGTACTTCTT	BR1
GAGTCCGTCAGTGCAT	BR1
GAGTCCGTCGGCCGAT	MGH
GATCAGTAGTGCCATT	MGH
GATCAGTCAATGGAGC	MGH
GATCAGTCACATTCGA	VU
GATCAGTTCCATGAGT	MGH
GATCAGTTCCGTTGCT	MGH
GATCGATAGCACGCCT	MGH
GATCGATCAACTGGCC	BR1
GATCGATCAGGATCGA	BR1
GATCGATTCACAATGC	MGH
GATCGATTCCGCGGTA	BR1
GATCGATTCGCCCTTA	MGH
GATCGCGCAAATACAG	BR1
GATCGCGCAAGCTGGA	BR1
GATCGCGCAGAAGCAC	BR1
GATCGCGGTTCTGAAC	BR1
GATCGCGTCCGAGCCA	BR1
GATCGCGTCCTACAGA	BR1
GATCGTAGTGTTTGTG	VU
GATCGTAGTTTACTCT	MGH
GATCGTATCAAGCCTA	MGH
GATCGTATCGTGGACC	VU
GATCGTATCTGTCTAT	BR1
GATCTAGAGGATCGCA	MGH
GATCTAGAGGATGTAT	MGH
GATCTAGAGGCTCAGA	MGH
GATCTAGCAAACAACA	MGH
GATCTAGCAAGAAGAG	BR1
GATCTAGCACAAGTAA	VU
GATCTAGCATATACCG	VU
GATCTAGCATCCGGGT	MGH
GATCTAGCATTCTCAT	MGH
GATCTAGGTAACGCGA	BR1
GATCTAGTCCGAATGT	BR1
GATCTAGTCCTAGGGC	BR1
GATGAAAAGCTAAGAT	BR1
GATGAAACACGCCAGT	BR1
GATGAAAGTAAGAGAG	BR1
GATGAAAGTTACGACT	MGH
GATGAAATCACAATGC	BR1
GATGAAATCACCAGGC	BR1
GATGAAATCTCGATGA	MGH
GATGAGGAGTTTGCGT	VU
GATGAGGTCACCTTAT	BR1
GATGAGGTCATTGCCC	MGH
GATGAGGTCGCCAAAT	VU
GATGAGGTCTGGTATG	VU
GATGAGGTCTGTCTAT	MGH
GATGCTAAGATTACCC	MGH
GATGCTACAAGGACAC	MGH
GATGCTACACGGTGTC	VU
GATGCTACAGGCGATA	BR1
GATGCTATCTCGCTTG	BR1
GATTCAGGTGTGTGCC	BR1
GATTCAGTCAGCTTAG	VU
GATTCAGTCAGGCGAA	MGH
GCAAACTAGACTAGGC	MGH
GCAAACTAGGGTATCG	BR1
GCAAACTAGTTACCCA	VU
GCAAACTCACTTCTGC	MGH
GCAAACTGTAGGCATG	BR1
GCAAACTGTGTTAAGA	BR1
GCAAACTGTTAGATGA	MGH
GCAAACTTCATACGGT	BR1
GCAAACTTCCTTGGTC	BR1
GCAAACTTCGAGAGCA	BR1
GCAATCAAGGCGTACA	MGH
GCAATCAAGTTACGGG	BR1
GCAATCACAAGGACAC	MGH
GCAATCACACGGTAAG	BR1
GCACATAAGCCAGTAG	BR1
GCACATAAGGACACCA	MGH
GCACATACATCGGAAG	BR1
GCACATAGTAGGAGTC	BR1
GCACATAGTGAACCTT	BR1
GCACATAGTTGGTGGA	MGH
GCACATATCAGAGACG	VU
GCACATATCCAAGCCG	BR1
GCACATATCGTCACGG	BR1
GCACTCTAGGCCCTCA	BR1
GCACTCTCAATGCCAT	BR1
GCACTCTCACGGCTAC	BR1
GCACTCTGTACGACCC	VU
GCACTCTGTAGCAAAT	BR1
GCACTCTGTGCGGTAA	VU
GCACTCTTCACTCTTA	VU
GCAGCCAAGCGTAATA	BR1
GCAGCCAAGCTGTTCA	MGH
GCAGCCACAAACTGTC	MGH
GCAGCCACACTTCGAA	MGH
GCAGCCACAGACGCAA	MGH
GCAGCCACAGCTGGCT	BR1
GCAGCCACATGGTAGG	MGH
GCAGCCAGTGTAAGTA	BR1
GCAGCCAGTTCGTCTC	BR1
GCAGCCATCATATCGG	BR1
GCAGTTAAGAAGCCCA	BR1
GCAGTTAAGAGACTAT	BR1
GCAGTTAAGCTAGTCT	BR1
GCAGTTAAGTACGATA	BR1
GCAGTTAAGTTTAGGA	BR1
GCAGTTACAAGCCGTC	MGH
GCAGTTACAATCGAAA	BR1
GCAGTTACACCTGGTG	MGH
GCAGTTACAGGGTACA	BR1
GCAGTTACATCATCCC	MGH
GCAGTTACATCGGTTA	MGH
GCAGTTAGTATCACCA	MGH
GCAGTTAGTGTAATGA	VU
GCAGTTAGTTACGACT	BR1
GCAGTTATCCGTCAAA	BR1
GCATACAAGCGTTCCG	MGH
GCATACAAGTTCGCGC	MGH
GCATACACACACCGAC	MGH
GCATACACAGGTGGAT	BR1
GCATACAGTAAATGAC	BR1
GCATACATCACCGGGT	MGH
GCATACATCGCATGGC	BR1
GCATACATCGGTTAAC	MGH
GCATGATAGACAATAC	BR1
GCATGATCATGGTTGT	MGH
GCATGATGTAAATACG	BR1
GCATGATGTAAGGGCT	MGH
GCATGATGTCTGATTG	MGH
GCATGATGTGACGGTA	MGH
GCATGATGTGCACCAC	BR1
GCATGATGTTCCACGG	MGH
GCATGATTCCTATTCA	VU
GCATGATTCTATCCCG	VU
GCATGCGAGAATCTCC	BR1
GCATGCGAGACAATAC	VU
GCATGCGAGATCCCGC	VU
GCATGCGCAACAACCT	BR1
GCATGCGCAAGACGTG	BR1
GCATGCGCATCCCATC	BR1
GCATGCGGTCAATGTC	BR1
GCATGCGGTCTGCAAT	VU
GCATGCGGTTAAAGTG	MGH
GCATGCGTCCTATTCA	VU
GCATGTAAGCGACGTA	VU
GCATGTAAGGGCATGT	BR1
GCATGTACACTTACGA	BR1
GCATGTATCGAGCCCA	BR1
GCATGTATCTTGCAAG	BR1
GCCAAATAGTTGCAGG	VU
GCCAAATCACAACGTT	MGH
GCCAAATCACATCCAA	BR1
GCCAAATGTAGGCTGA	BR1
GCCAAATGTTGTGGCC	VU
GCCAAATTCGTTTATC	VU
GCCTCTAAGAAAGTGG	VU
GCCTCTAAGGAATCGC	BR1
GCCTCTACAGCCTGTG	MGH
GCCTCTAGTAGCGCAA	MGH
GCCTCTAGTCTAGTCA	MGH
GCCTCTAGTGATGATA	MGH
GCCTCTATCTGCGGCA	MGH
GCGACCAAGACCCACC	MGH
GCGACCAAGCCACTAT	BR1
GCGACCAAGCCAGAAC	MGH
GCGACCAAGCTCTCGG	MGH
GCGACCAAGGGATACC	MGH
GCGACCAAGTGCAAGC	VU
GCGACCAAGTTCGCAT	MGH
GCGACCACAAGAAGAG	BR1
GCGACCACAGGTGCCT	MGH
GCGAGAACATCGGACC	BR1
GCGAGAAGTACAGCAG	MGH
GCGAGAAGTTAAGGGC	BR1
GCGCAACCAATGTAAG	BR1
GCGCAACCATCGGTTA	VU
GCGCAACTCACATACG	MGH
GCGCAACTCGCCGTGA	BR1
GCGCAGTAGTATTGGA	MGH
GCGCAGTGTCGCCATG	BR1
GCGCAGTTCGGAATCT	MGH
GCGCAGTTCTGCTGTC	BR1
GCGCCAAAGGCATGTG	BR1
GCGCCAAAGGTAGCTG	MGH
GCGCCAAGTCGACTGC	BR1
GCGCCAAGTCTGGTCG	BR1
GCGCCAAGTGCACTTA	BR1
GCGCCAAGTTGGAGGT	MGH
GCGCCAATCCTAGTGA	MGH
GCGCGATAGAAACGCC	VU
GCGCGATAGAAAGTGG	MGH
GCGCGATAGTGTTTGC	VU
GCGCGATCACGAGAGT	MGH
GCGCGATGTACTTGAC	MGH
GCGCGATGTAGAGTGC	MGH
GCGCGATGTCATGCAT	BR1
GCGCGATTCGGTTCGG	VU
GCGGGTTAGCCTTGAT	BR1
GCGGGTTAGCGAGAAA	MGH
GCGGGTTAGCTGCAAG	BR1
GCGGGTTAGGCATTGG	MGH
GCGGGTTCACACTGCG	BR1
GCGGGTTCATTCGACA	BR1
GCGGGTTGTTCCACTC	BR1
GCGGGTTTCGCATGAT	BR1
GCTCCTACAAGAAGAG	VU
GCTCCTACATCCGTGG	BR1
GCTCCTACATCTGGTA	MGH
GCTCCTATCAAACCGT	VU
GCTCTGTAGGGATGGG	VU
GCTCTGTAGTTAGGTA	MGH
GCTCTGTTCAACACCA	VU
GCTGCAGAGAGCTGCA	MGH
GCTGCAGAGTAGCGGT	BR1
GCTGCAGCAGTATCTG	VU
GCTGCAGCATACGCTA	MGH
GCTGCAGGTAAGAGGA	BR1
GCTGCAGGTCCGAACC	BR1
GCTGCAGTCATGCAAC	MGH
GCTGCAGTCCACGACG	VU
GCTGCAGTCCCTGACT	MGH
GCTGCAGTCGTTTAGG	BR1
GCTGCAGTCTGCTGCT	MGH
GCTGCAGTCTTCGGTC	BR1
GCTGCGAAGAATTGTG	BR1
GCTGCGAAGTTAAGTG	BR1
GCTGCGAAGTTCCACA	BR1
GCTGCGAGTAGCGCAA	VU
GCTGCGAGTCGGCACT	MGH
GCTGCGAGTTATCACG	BR1
GCTGCGAGTTTCGCTC	MGH
GCTGCGATCTCGGACG	BR1
GCTGCTTAGAGCCTAG	MGH
GCTGCTTAGTCCTCCT	MGH
GCTGCTTCAATAGAGT	BR1
GCTGCTTCAGTACACT	BR1
GCTGCTTCAGTTCCCT	MGH
GCTGCTTCATTCCTCG	BR1
GCTGCTTGTCTGGAGA	VU
GCTGCTTGTGCCTGTG	BR1
GCTGCTTGTGTCTGAT	BR1
GCTGCTTGTTAAGTAG	BR1
GCTGCTTTCTTAGCCC	MGH
GCTGCTTTCTTTACAC	VU
GCTGGGTAGGCTAGAC	MGH
GCTGGGTAGTCACGCC	VU
GCTGGGTAGTCGCCGT	MGH
GCTGGGTCAGGGAGAG	MGH
GCTGGGTCAGTCACTA	BR1
GCTGGGTCATGGGAAC	MGH
GCTGGGTGTACGCTGC	BR1
GCTGGGTGTATTCTCT	BR1
GCTGGGTTCACTCCTG	BR1
GCTGGGTTCCACGTGG	MGH
GCTGGGTTCCGGGTGT	BR1
GCTGGGTTCGGATGGA	MGH
GCTGGGTTCGGCGCAT	BR1
GCTGGGTTCTGCAGTA	MGH
GCTGGGTTCTGCCAGG	BR1
GCTGGGTTCTGTTGAG	VU
GCTGGGTTCTTGTCAT	MGH
GCTTCCAAGCTCCTCT	VU
GCTTCCACAAGCTGTT	BR1
GCTTCCACAATGCCAT	BR1
GCTTCCACAGGACGTA	BR1
GCTTCCACAGTAACGG	VU
GCTTCCAGTCGCGAAA	BR1
GCTTCCATCCGCGCAA	VU
GCTTCCATCCTTGCCA	MGH
GCTTCCATCTGTCAAG	BR1
GCTTGAAAGAGCTGCA	VU
GCTTGAAAGGCCGAAT	MGH
GCTTGAACACGGTTTA	BR1
GCTTGAACAGTAACGG	VU
GCTTGAACATCCGTGG	VU
GCTTGAAGTCTCTCTG	MGH
GCTTGAATCCTAGTGA	VU
GCTTGAATCCTCCTAG	MGH
GCTTGAATCTATCCTA	BR1
GGAAAGCCATTCTTAC	VU
GGAAAGCGTCAGAATA	BR1
GGAAAGCGTCATGCCG	BR1
GGAAAGCGTGCCTGGT	BR1
GGAAAGCGTTGATTGC	BR1
GGAAAGCTCTTGGGTA	MGH
GGAACTTAGAAGGTGA	BR1
GGAACTTCACCACCAG	VU
GGAACTTGTCTGGAGA	MGH
GGAACTTGTTCATGGT	MGH
GGAACTTGTTGAGTTC	MGH
GGAACTTTCGAATGCT	BR1
GGAATAAAGAAACGAG	MGH
GGAATAACACAGATTC	MGH
GGAATAACACCTCGTT	VU
GGAATAAGTATCGCAT	VU
GGAATAATCACAACGT	MGH
GGAATAATCTGCAGTA	BR1
GGACAAGCACGAAATA	BR1
GGACAAGCACGACTCG	MGH
GGACAAGCAGGAACGT	MGH
GGACAAGCATACCATG	VU
GGACAAGCATCAGTAC	BR1
GGACAAGCATGGATGG	BR1
GGACAAGTCAACGGGA	MGH
GGACAGAAGACGCTTT	VU
GGACAGAAGACTCGGA	MGH
GGACAGAAGATGTGGC	BR1
GGACAGAAGCAATCTC	MGH
GGACAGAAGCCAGAAC	BR1
GGACAGAAGTACGTTC	MGH
GGACAGACAATCAGAA	BR1
GGACAGACACGGCGTT	MGH
GGACAGACAGGTCCAC	MGH
GGACAGAGTACTCGCG	VU
GGACAGATCAGGCGAA	BR1
GGACATTAGGCTAGGT	MGH
GGACATTAGTCACGCC	BR1
GGACATTAGTTCCACA	MGH
GGACATTCAGCTGGCT	BR1
GGACATTGTAGCGCTC	VU
GGACATTTCAACACAC	BR1
GGACATTTCATCTGCC	MGH
GGACATTTCGACAGCC	MGH
GGACATTTCGCCATAA	BR1
GGACGTCCAAATTGCC	VU
GGACGTCCACTAAGTC	VU
GGACGTCCAGTAACGG	MGH
GGACGTCCATGGTAGG	MGH
GGACGTCGTGTAATGA	VU
GGACGTCTCACATACG	BR1
GGAGCAAAGGCCGAAT	MGH
GGAGCAACAAGGTTTC	BR1
GGAGCAACACCGAAAG	BR1
GGAGCAACACGGTAGA	BR1
GGAGCAAGTCTGCGGT	BR1
GGAGCAAGTTCAGACT	MGH
GGAGCAATCCATGAAC	BR1
GGAGCAATCTTGCCGT	BR1
GGATGTTAGCGGCTTC	MGH
GGATGTTAGCTAGTCT	MGH
GGATGTTAGCTCCCAG	BR1
GGATGTTAGGAATTAC	BR1
GGATGTTAGTCGATAA	BR1
GGATGTTAGTTCGCAT	MGH
GGATGTTCAAATTGCC	VU
GGATGTTGTCCAGTTA	BR1
GGATGTTGTGATGATA	BR1
GGATGTTGTTCCCTTG	BR1
GGATGTTTCCGAAGAG	MGH
GGATGTTTCCTAGGGC	BR1
GGATGTTTCGGTTAAC	MGH
GGATGTTTCTGTTTGT	MGH
GGATTACAGATCGGGT	VU
GGATTACAGCAGGTCA	BR1
GGATTACCAGCGTTCG	MGH
GGATTACCATGGATGG	VU
GGATTACGTCCGTGAC	MGH
GGATTACGTCGCGTGT	MGH
GGATTACGTGACGCCT	MGH
GGATTACGTGCAGACA	VU
GGATTACGTTACCAGT	MGH
GGATTACGTTCCACGG	BR1
GGATTACGTTGCTCCT	BR1
GGATTACTCGACGGAA	BR1
GGATTACTCGCCTGAG	BR1
GGATTACTCTGCAGTA	BR1
GGATTACTCTTGCCGT	VU
GGCAATTAGAAACCAT	BR1
GGCAATTAGAACTGTA	BR1
GGCAATTAGATGCCAG	VU
GGCAATTAGCAGACTG	BR1
GGCAATTAGGCAGTCA	VU
GGCAATTAGGCCCTTG	MGH
GGCAATTCATCCGTGG	MGH
GGCAATTGTCTAGAGG	MGH
GGCAATTTCAGCGATT	MGH
GGCAATTTCTATCGCC	BR1
GGCAATTTCTGTCTAT	BR1
GGCCGATAGAGTAATC	BR1
GGCCGATAGTCCAGGA	VU
GGCCGATAGTTTCCTT	VU
GGCCGATGTCTTCGTC	BR1
GGCCGATGTTCGGCAC	BR1
GGCGACTAGCTTCGCG	BR1
GGCGACTCAAGTTAAG	BR1
GGCGACTGTAGGCATG	VU
GGCGACTTCAAACCGT	BR1
GGCGACTTCGGCTACG	VU
GGCGTGTGTCATCCCT	BR1
GGCTCGAAGGCGATAC	MGH
GGCTCGAAGTCATGCT	BR1
GGCTCGAGTAATCGTC	BR1
GGCTCGATCCCAAGTA	BR1
GGCTGGTCAAATACAG	VU
GGCTGGTCACCTGGTG	BR1
GGCTGGTCATCAGTAC	BR1
GGCTGGTCATGAACCT	BR1
GGCTGGTGTAAGTAGT	BR1
GGCTGGTGTGTATGGG	BR1
GGCTGGTTCCCTCAGT	VU
GGCTGGTTCTTCGAGA	MGH
GGGAATGAGGTGCTAG	BR1
GGGAATGAGTTTGCGT	VU
GGGAATGCAACGCACC	BR1
GGGAATGCAATAACGA	BR1
GGGAATGCAATGGAAT	BR1
GGGAATGGTAGGACAC	VU
GGGAATGGTTACTGAC	BR1
GGGAATGGTTCCAACA	BR1
GGGAATGTCATAGCAC	BR1
GGGACCTGTTAAGTAG	VU
GGGACCTGTTGATTGC	MGH
GGGACCTTCACCGTAA	BR1
GGGACCTTCCTTCAAT	BR1
GGGAGATAGCCCAACC	BR1
GGGAGATAGCCGTCGT	MGH
GGGAGATAGCTAAGAT	BR1
GGGAGATAGGTAGCTG	BR1
GGGAGATAGTCATCCA	MGH
GGGAGATAGTTAGCGG	VU
GGGAGATCAAATACAG	MGH
GGGAGATCAAGCGTAG	MGH
GGGAGATCACCCATGG	MGH
GGGAGATCAGGAATCG	BR1
GGGAGATGTAGCTAAA	BR1
GGGAGATGTCGAGTTT	VU
GGGAGATGTCGGGTCT	BR1
GGGAGATGTGTGACCC	VU
GGGAGATGTTGGTTTG	MGH
GGGAGATTCGCGGATC	MGH
GGGAGATTCGTGACAT	BR1
GGGAGATTCTTAACCT	BR1
GGGATGAAGATGTCGG	BR1
GGGATGAAGCCAACAG	MGH
GGGATGAAGCTATGCT	MGH
GGGATGACAATAGCGG	BR1
GGGATGACAATGGTCT	VU
GGGATGACAGTCGATT	BR1
GGGATGAGTCATACTG	BR1
GGGATGATCAGCCTAA	VU
GGGATGATCATGTGGT	VU
GGGATGATCCACTCCA	VU
GGGCACTAGGCAGGTT	MGH
GGGCACTCACGTTGGC	VU
GGGCACTCATGAACCT	BR1
GGGCACTGTCCGAATT	BR1
GGGCACTGTCTGATCA	BR1
GGGCACTGTGTCGCTG	BR1
GGGCACTGTGTTGAGG	BR1
GGGCACTTCCACTCCA	BR1
GGGCACTTCTTAGAGC	BR1
GGGCATCAGCGGATCA	VU
GGGCATCAGCGTGAGT	BR1
GGGCATCAGGCGCTCT	BR1
GGGCATCAGGCTACGA	BR1
GGGCATCCAAGTACCT	BR1
GGGCATCCACATCTTT	MGH
GGGCATCCATTGGTAC	BR1
GGGCATCGTATCTGCA	MGH
GGGCATCGTGTCAATC	BR1
GGGCATCTCACAACGT	BR1
GGGCATCTCCATGAAC	BR1
GGGCATCTCCCTGACT	MGH
GGGCATCTCTGAGTGT	MGH
GGGTCTGCAATGAAAC	MGH
GGGTCTGCACTTAAGC	BR1
GGGTCTGCAGCGTTCG	VU
GGGTCTGCATTAGCCA	BR1
GGGTCTGGTGTTTGTG	BR1
GGGTCTGTCGTCACGG	BR1
GGGTTGCAGAATTCCC	VU
GGGTTGCCAACACGCC	MGH
GGGTTGCCACCCATGG	MGH
GGGTTGCCACGTTGGC	VU
GGGTTGCCATCGGGTC	MGH
GGGTTGCTCTGTCAAG	MGH
GGTATTGAGTGAATTG	VU
GGTATTGCACAAGCCC	VU
GGTATTGCACAGGTTT	BR1
GGTATTGCACATTAGC	MGH
GGTATTGCACCTATCC	MGH
GGTATTGCACGCATCG	MGH
GGTATTGCACTGTGTA	MGH
GGTATTGCAGTGGGAT	BR1
GGTATTGCATCGGACC	MGH
GGTATTGGTGTGAAAT	MGH
GGTGAAGCACAGACTT	BR1
GGTGAAGCATGGTAGG	MGH
GGTGAAGGTTTAGCTG	BR1
GGTGCGTCACTCAGGC	MGH
GGTGCGTGTCTAGAGG	MGH
GGTGCGTGTTACAGAA	MGH
GGTGCGTTCCTCTAGC	MGH
GGTGTTAAGCCAGGAT	VU
GGTGTTACACACCGAC	MGH
GGTGTTACAGCCTGTG	MGH
GGTGTTACATGCATGT	MGH
GGTGTTACATTGAGCT	VU
GGTGTTATCACAACGT	BR1
GTAACGTAGTAGCCGA	MGH
GTAACGTCACGCTTTC	MGH
GTAACGTCATCCAACA	MGH
GTAACGTGTCCTAGCG	BR1
GTAACGTGTCTCCACT	MGH
GTAACGTTCATGCTCC	BR1
GTAACGTTCCAAGCCG	BR1
GTAACGTTCGTTTATC	BR1
GTAACTGAGCGATTCT	MGH
GTAACTGCAAACTGTC	MGH
GTAACTGCAATGGAAT	BR1
GTAACTGTCACGAAGG	BR1
GTAACTGTCCACGCAG	BR1
GTACGTAAGCGCTCCA	BR1
GTACGTAAGGCAAAGA	MGH
GTACGTACACCTGGTG	MGH
GTACGTAGTCCTGCTT	BR1
GTACGTATCCTCAATT	VU
GTACGTATCGCCTGTT	BR1
GTACGTATCGGCCGAT	VU
GTACGTATCTCGCATC	BR1
GTACTCCAGACTGGGT	MGH
GTACTCCCAAAGGTGC	MGH
GTACTCCCAATCCAAC	BR1
GTACTCCCAGTCGTGC	BR1
GTACTCCGTCTACCTC	BR1
GTACTCCGTTTACTCT	MGH
GTACTCCTCACTCTTA	BR1
GTACTCCTCTTGTCAT	VU
GTACTTTAGAATGTGT	BR1
GTACTTTAGCGTAGTG	MGH
GTACTTTCATGGTAGG	BR1
GTACTTTGTATGAATG	MGH
GTACTTTTCAGCTGGC	MGH
GTACTTTTCCCTAACC	VU
GTACTTTTCTCTGCTG	BR1
GTAGGCCAGAGTGACC	BR1
GTAGGCCAGATCCCGC	MGH
GTAGGCCAGTCGATAA	MGH
GTAGGCCCAAACTGCT	MGH
GTAGGCCCACCCAGTG	BR1
GTAGGCCGTAGGAGTC	VU
GTAGGCCGTCCTAGCG	BR1
GTAGGCCGTCTTGTCC	BR1
GTAGGCCGTTCCTCCA	MGH
GTAGGCCTCAACACAC	MGH
GTAGGCCTCGTACGGC	BR1
GTAGGCCTCTGCCAGG	BR1
GTAGTCAAGTTAGGTA	MGH
GTAGTCACAAGGTTCT	MGH
GTAGTCACACTTAACG	BR1
GTAGTCACAGTACACT	BR1
GTAGTCAGTCTCACCT	MGH
GTAGTCAGTTCAGGCC	VU
GTAGTCATCAACACCA	MGH
GTAGTCATCCAATGGT	BR1
GTAGTCATCCGCGTTT	VU
GTAGTCATCCTACAGA	MGH
GTAGTCATCTGCGGCA	BR1
GTATCTTAGATACACA	MGH
GTATCTTAGGGCTTCC	VU
GTATCTTAGTGGGATC	BR1
GTATCTTCAAGTTCTG	BR1
GTATCTTCAGTTAACC	BR1
GTATCTTGTAGCGTCC	MGH
GTATTCTAGCGTCTAT	MGH
GTATTCTAGTGTCTCA	MGH
GTATTCTCAAGGACTG	BR1
GTATTCTCACAACGTT	BR1
GTATTCTCAGACGCAA	MGH
GTATTCTCAGCATGAG	MGH
GTATTCTGTAGCAAAT	VU
GTATTCTGTATTACCG	MGH
GTATTCTGTTCGCGAC	MGH
GTATTCTTCAGCTTAG	MGH
GTATTCTTCCAGATCA	BR1
GTATTCTTCCCTCAGT	BR1
GTATTCTTCGGAGGTA	BR1
GTCAAGTAGATAGCAT	BR1
GTCAAGTAGCCACGCT	BR1
GTCAAGTAGGTGTGGT	VU
GTCAAGTAGTAGGTGC	BR1
GTCAAGTAGTCTTGCA	VU
GTCAAGTAGTGTGAAT	BR1
GTCAAGTCAAGCCATT	BR1
GTCAAGTGTGAGGCTA	MGH
GTCAAGTGTGGCTCCA	VU
GTCAAGTGTTACAGAA	VU
GTCAAGTGTTGATTCG	MGH
GTCAAGTTCCGCTGTT	VU
GTCAAGTTCCGTTGTC	MGH
GTCAAGTTCCTAGTGA	VU
GTCACAAAGAAACGCC	MGH
GTCACAAAGACGCACA	BR1
GTCACAAAGATCCGAG	MGH
GTCACAAAGCGATCCC	VU
GTCACAAAGTGAAGTT	MGH
GTCACAACAGATCCAT	VU
GTCACAACAGGTTTCA	BR1
GTCACAAGTCTAAAGA	BR1
GTCACAAGTGAGGGTT	MGH
GTCACAAGTTCGCTAA	BR1
GTCACAATCAACACTG	BR1
GTCACAATCTGCCCTA	VU
GTCACGGAGATCTGAA	BR1
GTCACGGCACCCATTC	BR1
GTCACGGCAGATAATG	VU
GTCACGGCATGAAGTA	BR1
GTCACGGGTTAAGACA	MGH
GTCACGGGTTCTGTTT	MGH
GTCACGGGTTGTCTTT	MGH
GTCATTTAGGTGCTAG	BR1
GTCATTTAGTTGTCGT	VU
GTCATTTCAAAGAATC	BR1
GTCATTTCATCGGACC	BR1
GTCATTTGTCTCTCGT	BR1
GTCATTTGTTACAGAA	MGH
GTCATTTGTTACGTCA	BR1
GTCATTTTCTCTGAGA	VU
GTCCTCAAGCCTCGTG	BR1
GTCCTCAAGTGGTAGC	BR1
GTCCTCACAAGCTGTT	BR1
GTCCTCACACATGTGT	MGH
GTCCTCACAGCATGAG	BR1
GTCCTCACATGCAACT	VU
GTCCTCAGTATAGGTA	BR1
GTCCTCATCGAGCCCA	MGH
GTCGGGTCACGGCCAT	MGH
GTCGGGTCATATGAGA	BR1
GTCGGGTGTCAGAAGC	BR1
GTCGGGTGTCATCCCT	BR1
GTCGGGTGTCTAGCGC	MGH
GTCGGGTTCAGGCGAA	VU
GTCGGGTTCCCATTTA	VU
GTCGGGTTCTAACGGT	BR1
GTCGTAAAGAATGTGT	BR1
GTCGTAAAGATGCCAG	BR1
GTCGTAAAGGCTCATT	VU
GTCGTAAAGTTTGCGT	VU
GTCGTAACATGATCCA	BR1
GTCGTAAGTCATATCG	MGH
GTCGTAAGTGACCAAG	MGH
GTCGTAAGTGTCGCTG	BR1
GTCGTAATCCGATATG	BR1
GTCGTAATCTAAGCCA	BR1
GTCGTAATCTCCAGGG	BR1
GTCTCGTAGCGATTCT	MGH
GTCTCGTAGTTAGGTA	BR1
GTCTCGTCAATCCAAC	MGH
GTCTCGTCATCCCACT	BR1
GTCTCGTGTAATAGCA	VU
GTCTCGTGTACAGACG	VU
GTCTCGTGTCAATACC	BR1
GTCTCGTGTCTTGCGG	MGH
GTCTCGTTCATAGCAC	BR1
GTCTTCGAGGGTATCG	MGH
GTCTTCGAGGGTCTCC	MGH
GTCTTCGCATACTCTT	BR1
GTCTTCGGTACAAGTA	BR1
GTCTTCGTCGGCGCTA	VU
GTGAAGGAGCCAGAAC	VU
GTGAAGGAGGACAGCT	MGH
GTGAAGGCACCAGCAC	MGH
GTGAAGGCAGACGCTC	BR1
GTGAAGGCAGCATGAG	BR1
GTGAAGGCATTTCAGG	MGH
GTGAAGGGTGTTGAGG	BR1
GTGAAGGTCGGAGCAA	MGH
GTGAAGGTCTAACTGG	BR1
GTGCAGCCATGCAACT	MGH
GTGCAGCCATGGGAAC	BR1
GTGCAGCGTATCACCA	BR1
GTGCAGCGTTCCTCCA	VU
GTGCATAAGTAAGTAC	MGH
GTGCATACATACCATG	MGH
GTGCATAGTCACAAGG	BR1
GTGCATAGTCGAACAG	MGH
GTGCATAGTCTAGTGT	MGH
GTGCATATCAGCTCTC	MGH
GTGCATATCCACTCCA	MGH
GTGCATATCCCTCAGT	BR1
GTGCGGTAGAGGTACC	BR1
GTGCGGTCAGAGCCAA	VU
GTGCGGTCAGATCGGA	BR1
GTGCGGTGTAAATGTG	MGH
GTGCGGTGTAATTGGA	BR1
GTGCGGTGTGACTACT	VU
GTGCGGTTCACAGGCC	MGH
GTGCGGTTCGCTGATA	BR1
GTGCGGTTCTAACCGA	MGH
GTGCTTCCAATGGATA	VU
GTGCTTCGTAATCGTC	MGH
GTGCTTCGTGTTCGAT	MGH
GTGCTTCGTTACTGAC	BR1
GTGCTTCGTTCTGAAC	MGH
GTGGGTCAGCGTCAAG	MGH
GTGGGTCAGCTAGTGG	MGH
GTGGGTCAGGCCATAG	MGH
GTGGGTCCAAGCTGGA	BR1
GTGGGTCCACTTGGAT	BR1
GTGGGTCCATTAACCG	BR1
GTGGGTCGTCGAGTTT	BR1
GTGGGTCGTGTTGAGG	BR1
GTGGGTCGTTCCGTCT	MGH
GTGTGCGAGATGCCTT	BR1
GTGTGCGAGTGGAGTC	MGH
GTGTGCGCATCGGTTA	BR1
GTGTTAGAGCTGAACG	MGH
GTGTTAGAGTCTTGCA	BR1
GTGTTAGAGTGAACAT	MGH
GTGTTAGCAATCAGAA	MGH
GTGTTAGCAGAAGCAC	MGH
GTGTTAGGTCGCATAT	MGH
GTTAAGCAGAAACCGC	VU
GTTAAGCAGATGAGAG	BR1
GTTAAGCAGATGGCGT	VU
GTTAAGCCAATACGCT	BR1
GTTAAGCCACAAGCCC	MGH
GTTAAGCCACCAGGCT	MGH
GTTAAGCCACCTCGTT	BR1
GTTAAGCTCATCGGAT	MGH
GTTAAGCTCCTGTACC	BR1
GTTACAGAGGCTAGCA	BR1
GTTACAGCAGTTCATG	BR1
GTTACAGGTCACACGC	BR1
GTTACAGGTGATGCCC	BR1
GTTACAGGTTCTGAAC	BR1
GTTACAGTCCTCGCAT	BR1
GTTACAGTCTGGCGTG	MGH
GTTCATTAGTGGTAAT	VU
GTTCATTGTCTGCGGT	MGH
GTTCATTGTGCCTGTG	BR1
GTTCGGGAGAATGTGT	BR1
GTTCGGGAGCAATCTC	MGH
GTTCGGGAGGCTCATT	MGH
GTTCGGGAGTAGGTGC	BR1
GTTCGGGCAAGAAGAG	BR1
GTTCGGGGTCCGAATT	MGH
GTTCGGGGTCTCTCGT	MGH
GTTCGGGTCGGAAACG	BR1
GTTCTCGAGACTGGGT	MGH
GTTCTCGAGCCCAATT	MGH
GTTCTCGAGGGCTCTC	BR1
GTTCTCGCACGGTGTC	MGH
GTTCTCGGTAGCTGCC	MGH
GTTCTCGGTCATACTG	BR1
GTTCTCGGTCTAAACC	BR1
GTTCTCGGTTTACTCT	BR1
GTTCTCGTCACAGGCC	BR1
GTTCTCGTCGAACGGA	BR1
GTTCTCGTCGTAGGTT	VU
GTTTCTAAGTACGATA	VU
GTTTCTAAGTCTCCTC	VU
GTTTCTACACCAACCG	VU
GTTTCTACAGATCCAT	MGH
GTTTCTAGTACACCGC	VU
GTTTCTAGTCCTCTTG	BR1
GTTTCTAGTGTCGCTG	VU
GTTTCTATCAGAGGTG	BR1
TAAACCGGTTGTGGCC	BR1
TAAACCGTCCCGACTT	MGH
TAAACCGTCGTTTAGG	BR1
TAAACCGTCTAGCACA	MGH
TAAACCGTCTCTAAGG	VU
TAAGAGAAGTGAAGTT	BR1
TAAGAGAGTGCAACTT	BR1
TAAGAGAGTTCAGACT	BR1
TAAGAGAGTTTGTTTC	BR1
TAAGAGATCCGCAAGC	MGH
TAAGAGATCCTCAACC	BR1
TAAGCGTCACTGAAGG	BR1
TAAGCGTGTCGCATCG	VU
TAAGCGTGTGCATCTA	VU
TAAGCGTGTTCCCTTG	MGH
TAAGCGTGTTTGACAC	MGH
TAAGCGTTCGACGGAA	BR1
TAAGCGTTCGCGTAGC	BR1
TAAGCGTTCTCAACTT	BR1
TAAGCGTTCTCTTGAT	MGH
TAAGTGCAGAACTCGG	MGH
TAAGTGCAGATGGCGT	MGH
TAAGTGCAGCGCCTCA	VU
TAAGTGCAGGGTTCCC	VU
TAAGTGCAGTGGAGAA	VU
TAAGTGCCACCAGGTC	VU
TAAGTGCCACCGAATT	MGH
TAAGTGCCACCGATAT	MGH
TAAGTGCCATATGCTG	BR1
TAAGTGCGTAGCGTCC	VU
TAAGTGCTCAACACCA	BR1
TAAGTGCTCACATGCA	MGH
TAAGTGCTCATAAAGG	MGH
TACACGAAGAGGTTAT	MGH
TACACGAAGATCCCAT	MGH
TACACGAAGCAGCCTC	VU
TACACGAAGTACATGA	VU
TACACGACACTTCTGC	BR1
TACACGACAGTCACTA	BR1
TACACGACAGTCAGAG	VU
TACACGACATCACAAC	MGH
TACACGAGTCTAAACC	MGH
TACACGATCGCAGGCT	BR1
TACACGATCTAGAGTC	VU
TACACGATCTTGCCGT	BR1
TACAGTGAGCTCCTCT	MGH
TACAGTGCAAGCGCTC	MGH
TACAGTGCAGTATCTG	BR1
TACAGTGCATCCGCGA	MGH
TACAGTGCATCTGGTA	BR1
TACAGTGGTAGCAAAT	BR1
TACAGTGGTATAGTAG	MGH
TACAGTGTCCCAAGAT	BR1
TACAGTGTCGAGCCCA	MGH
TACCTATAGCGCCTTG	MGH
TACCTATCAATGGATA	BR1
TACCTATCAGCCTTGG	MGH
TACCTATCAGTTCATG	MGH
TACCTATGTAGCGCAA	BR1
TACCTATTCACCAGGC	BR1
TACCTATTCCTATGTT	MGH
TACCTATTCTGGCGAC	BR1
TACCTTAAGCTGATAA	MGH
TACCTTAAGTCAATAG	MGH
TACCTTACAATCTACG	BR1
TACCTTAGTAGGGTAC	VU
TACCTTAGTTCCCTTG	BR1
TACCTTAGTTGTGGCC	BR1
TACCTTATCCTTGACC	BR1
TACCTTATCTCGGACG	MGH
TACCTTATCTTACCTA	VU
TACGGATAGCGGATCA	BR1
TACGGATAGCTAGTGG	MGH
TACGGATGTCTCACCT	VU
TACGGATTCAACTCTT	BR1
TACGGATTCACGCATA	BR1
TACGGGCAGTTTCCTT	BR1
TACGGGCGTACATCCA	BR1
TACGGGCGTATAATGG	MGH
TACGGGCGTTAAAGAC	MGH
TACGGGCGTTACGTCA	MGH
TACGGGCGTTTACTCT	BR1
TACGGGCTCACAGGCC	BR1
TACGGGCTCGCCCTTA	MGH
TACGGGCTCGCGCCAA	VU
TACGGGCTCGTCTGAA	BR1
TACGGTAAGCGCCTCA	BR1
TACGGTAGTTTGTTGG	BR1
TACGGTATCACCATAG	BR1
TACGGTATCCCACTTG	BR1
TACTCATAGACCACGA	BR1
TACTCATAGTTTCCTT	VU
TACTCATCAATGCCAT	MGH
TACTCATGTCTAACGT	BR1
TACTCATGTGTGACCC	VU
TACTCATTCGTACGGC	MGH
TACTCGCAGGTGTTAA	MGH
TACTCGCGTGTGACCC	BR1
TACTCGCTCCACGTGG	MGH
TACTCGCTCGGAGGTA	VU
TACTCGCTCTCCGGTT	VU
TACTTACCACAAGACG	MGH
TACTTACCAGTATAAG	MGH
TACTTACCATCGATTG	BR1
TACTTACGTCCAGTGC	MGH
TACTTACGTTGGAGGT	BR1
TACTTACTCCACGTGG	BR1
TACTTACTCCTAAGTG	BR1
TACTTACTCGCCAGCA	BR1
TACTTACTCGGAGCAA	BR1
TACTTACTCGTTGCCT	VU
TACTTGTAGACGACGT	MGH
TACTTGTAGCTCCTCT	VU
TACTTGTAGTATCTCG	MGH
TACTTGTAGTGCAAGC	BR1
TACTTGTCAGACTCGC	BR1
TACTTGTCATAGTAAG	MGH
TACTTGTGTAAGTTCC	BR1
TACTTGTGTCGCGTGT	MGH
TACTTGTTCATTTGGG	VU
TACTTGTTCTGGGCCA	MGH
TAGACCAAGAAGAAGC	BR1
TAGACCAAGGCAGGTT	MGH
TAGACCAAGGTGATAT	MGH
TAGACCACACCGAATT	MGH
TAGACCACAGAGTGTG	VU
TAGACCATCAACGAAA	VU
TAGACCATCCAAGCCG	BR1
TAGACCATCGGATGTT	BR1
TAGAGCTAGCATCATC	VU
TAGAGCTAGTCCATAC	VU
TAGAGCTAGTTCGCAT	BR1
TAGAGCTCACTATCTT	BR1
TAGAGCTCACTTCTGC	MGH
TAGAGCTCAGGTGCCT	BR1
TAGAGCTCATCCCATC	BR1
TAGAGCTGTATGGTTC	BR1
TAGAGCTGTCGACTGC	VU
TAGAGCTGTTAAAGTG	VU
TAGAGCTTCAAACCGT	MGH
TAGCCGGCAAATCCGT	MGH
TAGCCGGCAAGGTTCT	BR1
TAGCCGGCAGGAACGT	BR1
TAGCCGGCATGGAATA	BR1
TAGCCGGGTCTGCGGT	MGH
TAGCCGGGTTAGTGGG	MGH
TAGCCGGTCCCATTAT	MGH
TAGCCGGTCTACTCAT	MGH
TAGGCATCATGGTCAT	BR1
TAGGCATCATGTAAGA	MGH
TAGGCATGTCTGGTCG	MGH
TAGTGGTAGAAACGAG	BR1
TAGTGGTAGCAGATCG	BR1
TAGTGGTCATGCAATC	BR1
TAGTGGTCATTAGGCT	VU
TAGTGGTTCAGCTCTC	BR1
TAGTGGTTCATAAAGG	MGH
TAGTGGTTCCAAAGTC	BR1
TAGTGGTTCCATGCTC	VU
TAGTTGGAGAATGTGT	BR1
TAGTTGGAGGATGTAT	MGH
TAGTTGGCACAGGCCT	BR1
TAGTTGGCAGTACACT	BR1
TAGTTGGGTAAACACA	MGH
TAGTTGGTCCATTCTA	MGH
TAGTTGGTCCTTGCCA	BR1
TATCAGGAGGTGCTAG	MGH
TATCAGGAGTGTACGG	BR1
TATCAGGGTGAGTATA	BR1
TATCTCACACCATGTA	BR1
TATCTCACAGTGAGTG	MGH
TATCTCAGTGGAAAGA	BR1
TATGCCCAGGTGCAAC	BR1
TATGCCCCACGGCGTT	MGH
TATGCCCTCGAATCCA	MGH
TATGCCCTCTCGTATT	BR1
TATTACCAGGACATTA	VU
TATTACCAGTCGTACT	MGH
TATTACCCAAACTGCT	MGH
TATTACCCAAAGGCGT	BR1
TATTACCCAGTCACTA	BR1
TATTACCGTAGCGCAA	BR1
TATTACCTCAAACAAG	BR1
TATTACCTCAACCAAC	BR1
TATTACCTCTTCGAGA	BR1
TCAACGAAGGAGTAGA	BR1
TCAACGAGTCGCCATG	BR1
TCAACGAGTCTCTCTG	BR1
TCAACGAGTGACGGTA	BR1
TCAACGAGTGTGCCTG	MGH
TCAACGATCCGTAGGC	VU
TCAACGATCTTCATGT	BR1
TCAATCTCAATAGCGG	BR1
TCAATCTCAATCGGTT	BR1
TCAATCTCACAACGTT	BR1
TCAATCTCACGTCTCT	BR1
TCAATCTGTAGCGTCC	BR1
TCAATCTGTAGCTGCC	MGH
TCAATCTGTATGAATG	MGH
TCAATCTGTCAAGCGA	BR1
TCAATCTGTCTCGTTC	MGH
TCACAAGAGTGTCCAT	MGH
TCACAAGGTCAGCTAT	MGH
TCACAAGGTCCAGTGC	VU
TCACAAGTCTGCCCTA	VU
TCACGAAAGAGACTTA	MGH
TCACGAAAGATCTGAA	BR1
TCACGAACAGATCGGA	BR1
TCACGAAGTAGCCTCG	MGH
TCACGAAGTATATGAG	BR1
TCACGAAGTATCACCA	VU
TCACGAAGTCCGAGTC	BR1
TCACGAAGTTACCAGT	MGH
TCACGAAGTTCGAATC	BR1
TCACGAATCATAGCAC	MGH
TCACGAATCGGATGTT	BR1
TCAGATGAGAGTGACC	MGH
TCAGATGAGTCTCGGC	MGH
TCAGATGCACATTCGA	MGH
TCAGATGCATAACCTG	MGH
TCAGATGGTATCACCA	MGH
TCAGATGGTCGATTGT	VU
TCAGCAAAGGCCATAG	BR1
TCAGCAAAGTGAACAT	VU
TCAGCAAAGTTATCGC	MGH
TCAGCAACACAACGCC	BR1
TCAGCAACAGCTTCGG	MGH
TCAGCAACATCGATTG	BR1
TCAGCAACATGCCACG	MGH
TCAGCAAGTACAGTTC	BR1
TCAGCAATCTAACCGA	BR1
TCAGCTCAGCCACCTG	MGH
TCAGCTCAGTTGAGAT	BR1
TCAGCTCCACCTGGTG	VU
TCAGCTCCAGCAGTTT	MGH
TCAGCTCCAGGGATTG	VU
TCAGCTCGTTCGTTGA	MGH
TCAGCTCTCACGGTTA	BR1
TCAGCTCTCAGTTGAC	BR1
TCAGCTCTCCACGCAG	VU
TCAGGATAGCTAGTCT	VU
TCAGGATAGTAGATGT	BR1
TCAGGATCAAGACACG	BR1
TCAGGATCACAACTGT	VU
TCAGGATCACAGTCGC	VU
TCAGGATCAGACAAAT	BR1
TCAGGATGTTAAGATG	BR1
TCAGGTAAGAATGTGT	VU
TCAGGTAAGAGTGACC	MGH
TCAGGTAAGGCCGAAT	BR1
TCAGGTACAATAACGA	MGH
TCAGGTACACGCATCG	MGH
TCAGGTACATCTATGG	BR1
TCAGGTAGTGCTGTAT	BR1
TCATTACAGACCACGA	BR1
TCATTACAGATGAGAG	MGH
TCATTACAGTTTCCTT	BR1
TCATTACCACAGGTTT	MGH
TCATTACCAGGTTTCA	MGH
TCATTACGTCGCGAAA	MGH
TCATTACGTTCAGACT	MGH
TCATTACTCCCTCTTT	VU
TCATTACTCCTGTACC	BR1
TCATTACTCGGATGTT	BR1
TCATTTGAGTGAATTG	MGH
TCATTTGCACAGATTC	VU
TCATTTGGTCAGTGGA	VU
TCATTTGTCGAGAGCA	BR1
TCCACACAGCGTGAGT	MGH
TCCACACCATCTCCCA	MGH
TCCACACCATGGAATA	MGH
TCCACACTCCCATTTA	MGH
TCCCGATAGTTAGGTA	BR1
TCCCGATCAAGTACCT	BR1
TCCCGATCATCACGAT	BR1
TCCCGATCATGAGCGA	MGH
TCCCGATGTGCGGTAA	MGH
TCCCGATGTGGTCTCG	MGH
TCCCGATGTTCCACTC	BR1
TCCCGATGTTTGTTTC	MGH
TCCCGATTCAAACGGG	MGH
TCCCGATTCAACGGGA	BR1
TCCCGATTCGGCATCG	MGH
TCCCGATTCTGCTGCT	BR1
TCGAGGCAGTCCAGGA	MGH
TCGAGGCAGTGTGAAT	BR1
TCGAGGCAGTTGAGTA	BR1
TCGAGGCCACAGGAGT	BR1
TCGAGGCCATCACCCT	BR1
TCGAGGCGTGTGAAAT	BR1
TCGAGGCTCAGATAAG	MGH
TCGCGAGAGCTCTCGG	BR1
TCGCGAGAGGCAATTA	BR1
TCGCGAGAGGCGACAT	MGH
TCGCGAGAGTTATCGC	VU
TCGCGAGAGTTGAGTA	BR1
TCGCGAGCAGCGTAAG	BR1
TCGCGAGCATTGAGCT	BR1
TCGCGAGGTACCGTTA	BR1
TCGCGAGGTAGGGTAC	BR1
TCGCGAGGTCAGCTAT	BR1
TCGCGAGTCCACGCAG	MGH
TCGCGAGTCCTCCTAG	MGH
TCGCGTTAGGTGCAAC	BR1
TCGCGTTAGTGGTAGC	VU
TCGCGTTGTCCGAACC	VU
TCGCGTTGTGTGGCTC	MGH
TCGCGTTGTTCACCTC	VU
TCGCGTTTCAGGCGAA	MGH
TCGCGTTTCTACTTAC	BR1
TCGCGTTTCTCGCTTG	MGH
TCGGGACAGAGACTTA	BR1
TCGGGACAGTCATGCT	BR1
TCGGGACAGTCGTACT	VU
TCGGGACAGTGGGATC	BR1
TCGGGACCACTAAGTC	BR1
TCGGGACGTAAACCTC	BR1
TCGGGACGTAGGCTGA	VU
TCGGGACGTGGCTCCA	BR1
TCGGGACGTGTGACGA	MGH
TCGGGACGTTTGTTGG	MGH
TCGGGACTCTGTGCAA	BR1
TCGGTAAAGCGCCTTG	MGH
TCGGTAAAGTTAGCGG	BR1
TCGGTAACACGGCGTT	BR1
TCGGTAACATAGGATA	MGH
TCGGTAAGTATAGTAG	MGH
TCGGTAAGTTGATTCG	BR1
TCGTACCAGACTCGGA	BR1
TCGTACCAGCCCAGCT	BR1
TCGTACCAGGATCGCA	MGH
TCGTACCAGGCAAAGA	BR1
TCGTACCAGGCCCGTT	BR1
TCGTACCAGTCCAGGA	VU
TCGTACCCAAGACACG	MGH
TCGTACCCATACAGCT	BR1
TCGTACCCATAGTAAG	BR1
TCGTACCGTAGGCATG	BR1
TCGTACCGTGAGGGAG	BR1
TCGTACCTCAGCTCGG	BR1
TCGTACCTCCGATATG	BR1
TCGTACCTCTTGGGTA	MGH
TCGTAGAAGACTGTAA	MGH
TCGTAGACAGGTGGAT	BR1
TCGTAGAGTAAACGCG	BR1
TCGTAGAGTAAGAGAG	MGH
TCGTAGAGTGCGGTAA	BR1
TCGTAGATCATTGCCC	MGH
TCGTAGATCCAGTATG	BR1
TCTATTGCAAGACACG	MGH
TCTATTGCACGAGGTA	MGH
TCTATTGGTACAGTTC	VU
TCTATTGGTCGCTTCT	MGH
TCTATTGGTGATAAAC	VU
TCTCATAAGCCGCCTA	MGH
TCTCATACAAGGACAC	MGH
TCTCATATCAAAGACA	BR1
TCTCATATCAAGCCTA	BR1
TCTCTAACAGCGTTCG	MGH
TCTCTAACAGGACCCT	BR1
TCTCTAACAGTATGCT	VU
TCTCTAACATATGAGA	MGH
TCTCTAACATTACCTT	MGH
TCTCTAAGTAGGGACT	BR1
TCTCTAAGTATATGAG	BR1
TCTCTAATCCAGTAGT	BR1
TCTCTAATCTCAAGTG	MGH
TCTCTAATCTGGAGCC	BR1
TCTGAGAAGTGAACAT	BR1
TCTGAGACACGACTCG	BR1
TCTGAGACACGGCGTT	BR1
TCTGAGACAGGGTTAG	MGH
TCTGAGACATGACATC	BR1
TCTGGAAAGTTGTCGT	VU
TCTGGAACACGGTTTA	BR1
TCTGGAACAGGACCCT	BR1
TCTGGAAGTTTGGCGC	BR1
TCTGGAATCACGCGGT	BR1
TCTGGAATCATCACCC	MGH
TCTGGAATCCTAGTGA	MGH
TCTGGAATCCTGTACC	MGH
TCTTCGGCAATCGGTT	VU
TCTTCGGCACTTAAGC	BR1
TCTTCGGCAGTAACGG	BR1
TCTTCGGGTAGGACAC	MGH
TCTTCGGTCCGAAGAG	MGH
TCTTTCCTCTCACATT	BR1
TGAAAGAAGCGAGAAA	MGH
TGAAAGAAGCGTGAGT	MGH
TGAAAGATCGCTTAGA	MGH
TGAAAGATCTAACCGA	MGH
TGACAACAGAGCAATT	BR1
TGACAACCAAAGTGCG	BR1
TGACAACCAAGGTTTC	BR1
TGACAACCACCCTATC	BR1
TGACAACCACGTGAGA	BR1
TGACAACCAGGGTATG	VU
TGACAACGTCTTCAAG	BR1
TGACAACGTTCGCGAC	VU
TGACAACTCACATAGC	MGH
TGACAACTCAGCGACC	MGH
TGACAACTCCTCCTAG	BR1
TGACAACTCCTCTAGC	MGH
TGACAACTCGGAAACG	VU
TGACAACTCGGTGTTA	MGH
TGACAACTCTCCCTGA	BR1
TGACGGCAGGTGATTA	VU
TGACGGCCATTCTCAT	BR1
TGACGGCGTATGAATG	MGH
TGACGGCGTTTGACTG	BR1
TGACGGCTCAAACCGT	BR1
TGACGGCTCTTGTTTG	BR1
TGACTAGAGCGCCTCA	VU
TGACTAGCATCAGTCA	BR1
TGACTAGGTGCACGAA	MGH
TGACTAGGTTCAGCGC	MGH
TGACTAGTCACTTCAT	BR1
TGACTAGTCCTCATTA	MGH
TGACTAGTCGTGGTCG	BR1
TGACTTTCAATTCCTT	VU
TGACTTTGTCCGAACC	VU
TGACTTTGTTTGGGCC	VU
TGAGAGGAGGCCCGTT	MGH
TGAGAGGAGTCCGTAT	MGH
TGAGAGGAGTGACTCT	VU
TGAGAGGGTACACCGC	VU
TGAGAGGGTCGAGATG	BR1
TGAGAGGTCTCGAGTA	VU
TGAGCATAGTGCCAGA	MGH
TGAGCATAGTGGGATC	VU
TGAGCATCATCCCACT	MGH
TGAGCATGTGACAAAT	MGH
TGAGCATGTGGCCCTA	VU
TGAGCATGTTGGTTTG	MGH
TGAGCCGAGAGACTAT	BR1
TGAGCCGAGGATGGTC	BR1
TGAGCCGAGTGAAGTT	MGH
TGAGCCGCAAACTGCT	MGH
TGAGCCGCAGTATCTG	MGH
TGAGCCGCATCACCCT	VU
TGAGCCGGTCTAAACC	MGH
TGAGCCGGTGTTTGTG	BR1
TGAGCCGGTTCGAATC	MGH
TGAGCCGGTTGCCTCT	VU
TGAGCCGTCAAGAAGT	VU
TGAGCCGTCACCTCGT	BR1
TGAGCCGTCGATAGAA	BR1
TGAGCCGTCTCACATT	MGH
TGAGGGAAGCCGCCTA	VU
TGAGGGACAAGTTAAG	MGH
TGAGGGACAATCGAAA	MGH
TGAGGGACACCACGTG	BR1
TGAGGGACAGGTCTCG	VU
TGAGGGAGTAGAAAGG	BR1
TGAGGGAGTCTGGTCG	BR1
TGAGGGAGTGTGAAAT	BR1
TGAGGGATCTGCGTAA	BR1
TGATTTCAGCTGGAAC	BR1
TGATTTCGTACAGACG	MGH
TGATTTCGTCAGCTAT	MGH
TGATTTCGTCTAGTCA	MGH
TGATTTCGTTAAGACA	BR1
TGATTTCTCGCATGAT	MGH
TGCACCTTCTGTCTCG	BR1
TGCCAAAAGATCCCGC	VU
TGCCAAAAGGTGCTAG	BR1
TGCCAAACACGAGAGT	BR1
TGCCAAACATCGGTTA	BR1
TGCCAAACATTAGGCT	BR1
TGCCAAAGTCATTAGC	BR1
TGCCAAAGTTACGACT	MGH
TGCCCATAGAGTTGGC	MGH
TGCCCATAGCCCAATT	BR1
TGCCCTAAGCAGATCG	MGH
TGCCCTAAGCTGTTCA	MGH
TGCCCTAAGTGTCCCG	MGH
TGCCCTATCCTTTCGG	MGH
TGCCCTATCGTTTATC	BR1
TGCCCTATCTTTAGGG	VU
TGCGCAGAGTCCAGGA	BR1
TGCGCAGAGTGGGTTG	VU
TGCGCAGCACCGATAT	MGH
TGCGCAGGTCATATGC	BR1
TGCGCAGTCACTTATC	MGH
TGCGCAGTCGTACCGG	BR1
TGCGCAGTCTTGGGTA	MGH
TGCGGGTAGGATCGCA	VU
TGCGGGTAGTGAAGAG	BR1
TGCGGGTCACTGAAGG	BR1
TGCGGGTGTCTACCTC	MGH
TGCGGGTGTTAAGTAG	MGH
TGCGGGTTCAGAAATG	MGH
TGCGGGTTCTAACTGG	VU
TGCGGGTTCTCTGCTG	MGH
TGCGTGGAGTAGTGCG	BR1
TGCGTGGAGTCAATAG	BR1
TGCGTGGCACGAGAGT	VU
TGCGTGGCACTTGGAT	MGH
TGCGTGGTCGTACCGG	MGH
TGCTACCAGATGGCGT	BR1
TGCTACCCAAGAGTCG	BR1
TGCTACCGTACTCGCG	BR1
TGCTACCGTTTGTTTC	MGH
TGCTACCTCCGTAGGC	BR1
TGCTGCTGTAGCGATG	VU
TGCTGCTGTCCGAAGA	VU
TGCTGCTTCAACACGT	VU
TGGACGCGTAAGGGCT	BR1
TGGACGCGTCCGAAGA	MGH
TGGACGCTCCCTGACT	MGH
TGGCCAGAGAAGGTTT	VU
TGGCCAGAGTCATGCT	BR1
TGGCCAGAGTTAACGA	MGH
TGGCCAGTCTGCTGCT	BR1
TGGCGCAAGGCGCTCT	MGH
TGGCGCAAGGGTATCG	MGH
TGGCGCAAGGTGATAT	BR1
TGGCGCAAGTACACCT	BR1
TGGCGCAAGTTGAGAT	MGH
TGGCGCACAAGTAGTA	MGH
TGGCGCACACTGAAGG	BR1
TGGCTGGAGTGCCATT	BR1
TGGCTGGCATAGAAAC	MGH
TGGCTGGGTAGAAGGA	BR1
TGGCTGGGTGGCAAAC	BR1
TGGGAAGAGAATCTCC	BR1
TGGGAAGCAAGGTTTC	BR1
TGGGAAGCAATGACCT	BR1
TGGGAAGCATTCTCAT	BR1
TGGGAAGTCAACACCA	BR1
TGGGAAGTCAGGTAAA	MGH
TGGGAAGTCGACGGAA	BR1
TGGGAAGTCGTCTGAA	MGH
TGGGCGTAGGCACATG	VU
TGGGCGTAGTATCGAA	MGH
TGGGCGTCAAGTTAAG	BR1
TGGGCGTCAGATCTGT	MGH
TGGGCGTGTACCGGCT	MGH
TGGGCGTGTCACTGGC	BR1
TGGGCGTGTTGGACCC	MGH
TGGGCGTTCCAGAAGG	BR1
TGGGCGTTCCGCGTTT	BR1
TGGGCGTTCGCGTAGC	VU
TGGGCGTTCGCTGATA	BR1
TGGTTAGAGAGTAATC	MGH
TGGTTAGAGGCCCGTT	BR1
TGGTTAGTCATGTGGT	VU
TGGTTAGTCCAAGTAC	VU
TGGTTAGTCCACTCCA	BR1
TGGTTAGTCTTAACCT	MGH
TGGTTAGTCTTTAGTC	BR1
TGGTTCCAGGACAGAA	VU
TGGTTCCAGTGTACCT	BR1
TGGTTCCAGTTTGCGT	MGH
TGGTTCCCAACGCACC	MGH
TGGTTCCCAAGCCCAC	MGH
TGGTTCCCAAGTTAAG	MGH
TGGTTCCCATGGTAGG	BR1
TGGTTCCGTTGTGGCC	BR1
TGGTTCCTCAGTTAGC	MGH
TGGTTCCTCGAACGGA	MGH
TGGTTCCTCGCGTTTC	BR1
TGTATTCAGAGGTACC	BR1
TGTATTCCAAGCCGTC	VU
TGTATTCCAAGGACAC	VU
TGTATTCGTCAGTGGA	BR1
TGTATTCGTTGGAGGT	MGH
TGTATTCTCAAACAAG	BR1
TGTATTCTCATGTCTT	BR1
TGTATTCTCCGTTGTC	BR1
TGTATTCTCGAATGCT	MGH
TGTCCCAAGTTACGGG	MGH
TGTCCCACAAAGCAAT	VU
TGTCCCACAGGACCCT	BR1
TGTCCCACATCTACGA	BR1
TGTCCCAGTAGGAGTC	VU
TGTCCCATCCTCTAGC	MGH
TGTGGTAAGACAAGCC	BR1
TGTGGTAAGACCGGAT	BR1
TGTGGTAAGATAGGAG	BR1
TGTGGTAAGCCAACAG	BR1
TGTGGTACATCTCCCA	BR1
TGTGGTAGTGCCTTGG	MGH
TGTGTTTCACAAGTAA	BR1
TGTGTTTCACGGTGTC	MGH
TGTGTTTGTACAGTGG	VU
TGTGTTTGTGCACGAA	BR1
TGTGTTTGTGCCTTGG	BR1
TGTGTTTGTGGTACAG	BR1
TGTGTTTGTTACGCGC	VU
TGTGTTTTCCACGACG	VU
TGTGTTTTCTGCTGCT	BR1
TGTTCCGAGACAGACC	BR1
TGTTCCGCAAAGTGCG	BR1
TGTTCCGCAGATAATG	BR1
TGTTCCGGTGCGCTTG	BR1
TGTTCCGTCGGAATCT	BR1
TTAACTCAGTATTGGA	BR1
TTAACTCCACATTAGC	MGH
TTAACTCGTACCGGCT	BR1
TTAACTCGTCCGAAGA	BR1
TTAACTCGTCGGCTCA	BR1
TTAACTCGTGGTACAG	MGH
TTAACTCGTGTCGCTG	BR1
TTAACTCGTTTCGCTC	VU
TTAACTCTCATGTCCC	VU
TTAGGACAGCGTAATA	MGH
TTAGGACAGGTGACCA	BR1
TTAGGACAGTCCTCCT	MGH
TTAGGACAGTTCCACA	MGH
TTAGGACCACTGCCAG	MGH
TTAGGACCAGCTCGCA	MGH
TTAGGACCATTCTCAT	BR1
TTAGGACTCAACACGT	BR1
TTAGGACTCAACGCTA	MGH
TTAGGACTCAAGCCTA	BR1
TTAGGACTCGCTTAGA	BR1
TTAGGCAAGAAACCTA	BR1
TTAGGCAAGGGTCTCC	BR1
TTAGGCAAGTCTCAAC	VU
TTAGGCAAGTGAAGTT	BR1
TTAGGCACACCAACCG	BR1
TTAGGCACACCGCTAG	BR1
TTAGGCACACGTGAGA	BR1
TTAGGCACACTTAACG	MGH
TTAGGCACAGGGTATG	BR1
TTAGGCACATTCCTCG	BR1
TTAGGCAGTGTCCTCT	MGH
TTAGGCATCACGACTA	VU
TTAGGCATCCGCATCT	VU
TTAGGCATCCTGCTTG	VU
TTAGTTCAGCGATCCC	MGH
TTAGTTCAGCGTCAAG	MGH
TTAGTTCAGGATCGCA	BR1
TTAGTTCCACTTACGA	VU
TTAGTTCGTAACGCGA	VU
TTAGTTCGTCGCATAT	VU
TTATGCTAGCTGAACG	BR1
TTATGCTAGGGAAACA	BR1
TTATGCTAGTATCGAA	MGH
TTATGCTCAAAGTGCG	VU
TTATGCTCAATGGATA	MGH
TTATGCTCAGGTGGAT	MGH
TTATGCTCATGTCTCC	BR1
TTATGCTCATTCTTAC	VU
TTATGCTTCAAACCAC	VU
TTATGCTTCAACACTG	MGH
TTATGCTTCTCCGGTT	MGH
TTCCCAGCAGCCTTTC	BR1
TTCCCAGCAGTCCTTC	BR1
TTCCCAGGTGACGGTA	BR1
TTCCCAGGTGGTACAG	BR1
TTCCCAGTCAAACCAC	BR1
TTCCCAGTCGGAGGTA	BR1
TTCGAAGAGACTAGAT	MGH
TTCGAAGAGGTGCAAC	BR1
TTCGAAGCAGAAGCAC	BR1
TTCGAAGGTTCAGTAC	MGH
TTCGAAGGTTGTCGCG	BR1
TTCGAAGTCACCTCGT	MGH
TTCGGTCAGAGCTGGT	BR1
TTCGGTCCAAGCCGTC	MGH
TTCGGTCCACAGTCGC	BR1
TTCGGTCCATGTAAGA	VU
TTCGGTCCATTCCTGC	MGH
TTCGGTCGTCCCGACA	MGH
TTCGGTCGTGAGGCTA	BR1
TTCGGTCTCTGTTGAG	VU
TTCTACAAGAGGACGG	BR1
TTCTACAAGATCCCGC	MGH
TTCTACAAGGCGACAT	BR1
TTCTACAAGTAGTGCG	BR1
TTCTACACACCAGCAC	BR1
TTCTACACATGCCTAA	VU
TTCTACACATGCTAGT	BR1
TTCTACAGTCATCCCT	MGH
TTCTACAGTGCGCTTG	MGH
TTCTACATCATTCACT	BR1
TTCTACATCGCATGAT	BR1
TTCTACATCTAGAGTC	MGH
TTCTACATCTTGTATC	MGH
TTCTCAAGTAAGGATT	BR1
TTCTCAAGTTCGTCTC	BR1
TTCTCAATCTCTTGAT	BR1
TTCTCCTAGAGCTTCT	MGH
TTCTCCTAGGAGTCTG	VU
TTCTCCTGTTGGAGGT	BR1
TTCTCCTTCAATAAGG	MGH
TTCTTAGAGGACATTA	VU
TTCTTAGAGGATGGTC	MGH
TTCTTAGCACCGAAAG	BR1
TTCTTAGCAGGTGCCT	BR1
TTCTTAGCAGTCTTCC	BR1
TTCTTAGCATCCTTGC	MGH
TTCTTAGGTACAGCAG	BR1
TTCTTAGGTGACGGTA	MGH
TTCTTAGGTGTTCGAT	BR1
TTGAACGAGATAGCAT	VU
TTGAACGCAACGCACC	MGH
TTGAACGGTGCCTGCA	BR1
TTGAACGTCGTAGGAG	BR1
TTGACTTAGAAGCCCA	VU
TTGACTTAGAGCAATT	MGH
TTGACTTAGTGTCTCA	VU
TTGACTTGTCGAGTTT	VU
TTGACTTGTCGGCTCA	VU
TTGACTTGTGCCTGTG	BR1
TTGACTTTCAAGCCTA	VU
TTGACTTTCGACCAGC	MGH
TTGACTTTCTCGCATC	BR1
TTGCCGTAGTTCGCAT	BR1
TTGCCGTCATGCGCAC	VU
TTGCCGTGTCCAACTA	VU
TTGCCGTGTTGTCGCG	BR1
TTGCCGTTCGCCCTTA	BR1
TTGCCGTTCGTTACAG	BR1
TTGCGTCAGCACAGGT	MGH
TTGCGTCAGGGATACC	MGH
TTGCGTCGTCTGCCAG	VU
TTGCGTCTCTCTGAGA	BR1
TTGGAACAGAATGTGT	MGH
TTGGAACCAAAGCAAT	MGH
TTGGAACCAATCGGTT	MGH
TTGGAACGTTGAGGTG	BR1
TTGGAACTCAGTCAGT	VU
TTGGAACTCTCATTCA	BR1
TTGGAACTCTTCCTTC	MGH
TTGGCAAAGAAACGAG	MGH
TTGGCAAAGAATAGGG	BR1
TTGGCAAAGTGTTTGC	VU
TTGGCAACAATAGCGG	MGH
TTGGCAACACACGCTG	BR1
TTGGCAACATCCTAGA	MGH
TTGGCAAGTCAAGCGA	BR1
TTGGCAAGTTATCACG	BR1
TTGGCAATCAGCATGT	MGH
TTGGCAATCTAGAGTC	VU
TTGTAGGAGATGGCGT	MGH
TTGTAGGAGCGAGAAA	MGH
TTGTAGGTCACAATGC	VU
TTGTAGGTCAGTTGAC	VU
TTTACTGAGGCTAGGT	BR1
TTTACTGAGTACGTTC	MGH
TTTACTGCAAGGACAC	BR1
TTTACTGCAGAAGCAC	BR1
TTTACTGCATCGGGTC	MGH
TTTACTGGTAGCCTAT	MGH
TTTACTGTCCTGCAGG	BR1
TTTACTGTCGGCGCAT	BR1
TTTATGCAGATCCCGC	BR1
TTTATGCAGGAGCGAG	MGH
TTTATGCCAAGGTTTC	BR1
TTTATGCCAATAGCGG	VU
TTTATGCCAGGATCGA	MGH
TTTATGCCATCTCCCA	MGH
TTTATGCGTAACGACG	BR1
TTTATGCGTCGAAAGC	BR1
TTTATGCGTGTAACGG	VU
TTTATGCGTTACAGAA	MGH
TTTATGCGTTATCCGA	BR1
TTTCCTCAGCGATTCT	MGH
TTTCCTCCAGACGTAG	BR1
TTTCCTCCAGGGAGAG	BR1
TTTCCTCCATTCGACA	MGH
TTTCCTCGTAAGTAGT	BR1
TTTCCTCGTAGCTTGT	VU
TTTCCTCGTGAAGGCT	BR1
TTTCCTCGTTGATTGC	VU
TTTCCTCTCACGACTA	VU
TTTCCTCTCCACTCCA	MGH
TTTGCGCAGGATGGTC	BR1
TTTGCGCAGGCTCAGA	BR1
TTTGCGCAGTAGATGT	MGH
TTTGCGCCAACCGCCA	BR1
TTTGCGCCACAAGACG	BR1
TTTGCGCCAGCCTTGG	MGH
TTTGCGCGTCTAGTCA	MGH
TTTGCGCGTCTTGTCC	VU
TTTGCGCTCCAGGGCT	MGH
TTTGCGCTCTTGTACT	BR1
TTTGGTTAGGGCATGT	VU
TTTGGTTGTGTGACGA	MGH
TTTGTCAAGACCGGAT	BR1
TTTGTCAAGAGCCCAA	BR1
TTTGTCAAGAGGGCTT	BR1
TTTGTCACACAAGACG	BR1
TTTGTCACACCAACCG	BR1
TTTGTCACACTTAAGC	MGH
TTTGTCACATCGATGT	MGH
TTTGTCACATGGTAGG	MGH
TTTGTCAGTGCACCAC	BR1
TTTGTCAGTTAAGTAG	VU
TTTGTCATCACAGGCC	BR1
TTTGTCATCACTATTC	BR1
TTTGTCATCCAGAAGG	MGH
TTTGTCATCGCGCCAA	BR1
TTTGTCATCTGCTGCT	MGH
